date,covidOccupiedMVBeds,cumAdmissions,hospitalCases,newAdmissions,Vax_index,dailyCases,cumulativeCases
2020-04-02,1494.0,26264,12135.0,2932,0.32999999999999996,4097,41174
2020-04-03,1788.0,28828,13635.0,2564,0.32999999999999996,4102,45276
2020-04-04,1950.0,31421,15469.0,2593,0.32999999999999996,3405,48681
2020-04-05,2097.0,34013,16657.0,2592,0.32999999999999996,3094,51775
2020-04-06,2264.0,36692,17154.0,2679,0.32999999999999996,4407,56182
2020-04-07,2472.0,39436,17814.0,2744,0.32999999999999996,4605,60787
2020-04-08,2561.0,42055,18152.0,2619,0.32999999999999996,4315,65102
2020-04-09,2546.0,44395,18423.0,2340,0.32999999999999996,4076,69178
2020-04-10,2820.0,46591,18669.0,2196,0.32999999999999996,3590,72768
2020-04-11,2865.0,48546,18604.0,1955,0.32999999999999996,3085,75853
2020-04-12,2881.0,50337,18974.0,1791,0.32999999999999996,2958,78811
2020-04-13,2872.0,52249,18621.0,1912,0.32999999999999996,3463,82274
2020-04-14,2849.0,54108,18552.0,1859,0.32999999999999996,3568,85842
2020-04-15,2847.0,55716,17934.0,1608,0.32999999999999996,4240,90082
2020-04-16,2838.0,57493,17783.0,1777,0.32999999999999996,4360,94442
2020-04-17,2780.0,59167,16728.0,1674,0.32999999999999996,4088,98530
2020-04-18,2868.0,60578,16850.0,1411,0.32999999999999996,4142,102672
2020-04-19,2820.0,62053,16928.0,1475,0.32999999999999996,3494,106166
2020-04-20,2780.0,63575,16654.0,1522,0.32999999999999996,3698,109864
2020-04-21,2701.0,65070,16517.0,1495,0.32999999999999996,3996,113860
2020-04-22,2646.0,66380,16018.0,1310,0.32999999999999996,4812,118672
2020-04-23,2563.0,67669,15402.0,1289,0.32999999999999996,4574,123246
2020-04-24,2414.0,68946,14642.0,1277,0.32999999999999996,4352,127598
2020-04-25,2405.0,70026,14202.0,1080,0.32999999999999996,3381,130979
2020-04-26,2309.0,71234,14174.0,1208,0.32999999999999996,3137,134116
2020-04-27,2194.0,72578,14255.0,1344,0.32999999999999996,4056,138172
2020-04-28,2093.0,73874,13565.0,1296,0.32999999999999996,4113,142285
2020-04-29,2045.0,75169,13224.0,1295,0.32999999999999996,4737,147022
2020-04-30,1991.0,76396,12922.0,1227,0.32999999999999996,4314,151336
2020-05-01,1954.0,77477,12623.0,1081,0.32999999999999996,4109,155445
2020-05-02,1844.0,78457,12314.0,980,0.32999999999999996,2762,158207
2020-05-03,1795.0,79501,12119.0,1044,0.32999999999999996,2648,160855
2020-05-04,1724.0,80564,12020.0,1063,0.32999999999999996,2851,163706
2020-05-05,1662.0,81523,11754.0,959,0.32999999999999996,3148,166854
2020-05-06,1610.0,82563,11227.0,1040,0.32999999999999996,3264,170118
2020-05-07,1493.0,83561,10726.0,998,0.32999999999999996,3205,173323
2020-05-08,1446.0,84304,10249.0,743,0.32999999999999996,2622,175945
2020-05-09,1398.0,85102,10176.0,798,0.32999999999999996,1797,177742
2020-05-10,1362.0,85858,9893.0,756,0.32999999999999996,2013,179755
2020-05-11,1316.0,86724,10109.0,866,0.32999999999999996,3088,182843
2020-05-12,1247.0,87568,9791.0,844,0.32999999999999996,2940,185783
2020-05-13,1198.0,88372,9602.0,804,0.32999999999999996,2899,188682
2020-05-14,1162.0,89135,9231.0,763,0.32999999999999996,2222,190904
2020-05-15,1200.0,89873,9079.0,738,0.32999999999999996,2145,193049
2020-05-16,1101.0,90544,8643.0,671,0.32999999999999996,1781,194830
2020-05-17,1064.0,91217,8611.0,673,0.32999999999999996,1593,196423
2020-05-18,1010.0,91950,8668.0,733,0.32999999999999996,2226,198649
2020-05-19,976.0,92702,8518.0,752,0.32999999999999996,2602,201251
2020-05-20,921.0,93434,8115.0,732,0.32999999999999996,2359,203610
2020-05-21,894.0,94149,7903.0,715,0.32999999999999996,2277,205887
2020-05-22,852.0,94787,7761.0,638,0.32999999999999996,1798,207685
2020-05-23,815.0,95291,7428.0,504,0.32999999999999996,1309,208994
2020-05-24,786.0,95788,7415.0,497,0.32999999999999996,1206,210200
2020-05-25,771.0,96286,7448.0,498,0.32999999999999996,1389,211589
2020-05-26,756.0,96864,7305.0,578,0.32999999999999996,1461,213050
2020-05-27,696.0,97453,6836.0,589,0.32999999999999996,1616,214666
2020-05-28,663.0,98023,6528.0,570,0.32999999999999996,1575,216241
2020-05-29,630.0,98522,6250.0,499,0.32999999999999996,1374,217615
2020-05-30,628.0,98988,5972.0,466,0.32999999999999996,1010,218625
2020-05-31,606.0,99434,5933.0,446,0.32999999999999996,984,219609
2020-06-01,584.0,99956,5954.0,522,0.32999999999999996,1319,220928
2020-06-02,553.0,100509,5827.0,553,0.32999999999999996,1365,222293
2020-06-03,523.0,101000,5600.0,491,0.32999999999999996,1251,223544
2020-06-04,494.0,101458,5398.0,458,0.32999999999999996,1147,224691
2020-06-05,481.0,101838,5213.0,380,0.32999999999999996,1020,225711
2020-06-06,473.0,102144,5004.0,306,0.32999999999999996,723,226434
2020-06-07,448.0,102467,4820.0,323,0.32999999999999996,668,227102
2020-06-08,443.0,102815,4830.0,348,0.32999999999999996,990,228092
2020-06-09,427.0,103212,4665.0,397,0.32999999999999996,1066,229158
2020-06-10,384.0,103614,4447.0,402,0.32999999999999996,1086,230244
2020-06-11,334.0,103944,4179.0,330,0.32999999999999996,915,231159
2020-06-12,336.0,104242,4136.0,298,0.32999999999999996,938,232097
2020-06-13,339.0,104507,4000.0,265,0.32999999999999996,785,232882
2020-06-14,343.0,104813,3973.0,306,0.32999999999999996,752,233634
2020-06-15,327.0,105178,3920.0,365,0.32999999999999996,944,234578
2020-06-16,327.0,105532,3934.0,354,0.32999999999999996,996,235574
2020-06-17,300.0,105866,3826.0,334,0.32999999999999996,914,236488
2020-06-18,299.0,106178,3681.0,312,0.32999999999999996,938,237426
2020-06-19,283.0,106431,3575.0,253,0.32999999999999996,818,238244
2020-06-20,297.0,106615,3423.0,184,0.32999999999999996,626,238870
2020-06-21,265.0,106830,3373.0,215,0.32999999999999996,550,239420
2020-06-22,296.0,107148,3417.0,318,0.32999999999999996,821,240241
2020-06-23,266.0,107423,3288.0,275,0.32999999999999996,727,240968
2020-06-24,264.0,107685,3223.0,262,0.32999999999999996,732,241700
2020-06-25,236.0,107941,3066.0,256,0.32999999999999996,643,242343
2020-06-26,226.0,108189,2859.0,248,0.32999999999999996,640,242983
2020-06-27,233.0,108398,2819.0,209,0.32999999999999996,506,243489
2020-06-28,236.0,108553,2818.0,155,0.32999999999999996,413,243902
2020-06-29,228.0,108725,3024.0,172,0.32999999999999996,666,244568
2020-06-30,238.0,108914,2665.0,189,0.32999999999999996,578,245146
2020-07-01,220.0,109115,2509.0,201,0.32999999999999996,607,245753
2020-07-02,211.0,109264,2410.0,149,0.32999999999999996,561,246314
2020-07-03,202.0,109410,2294.0,146,0.32999999999999996,536,246850
2020-07-04,186.0,109530,2152.0,120,0.32999999999999996,385,247235
2020-07-05,190.0,109661,2100.0,131,0.32999999999999996,544,247779
2020-07-06,188.0,109811,2099.0,150,0.32999999999999996,664,248443
2020-07-07,178.0,109959,2010.0,148,0.32999999999999996,565,249008
2020-07-08,164.0,110100,1888.0,141,0.32999999999999996,682,249690
2020-07-09,167.0,110236,1801.0,136,0.32999999999999996,688,250378
2020-07-10,162.0,110340,1746.0,104,0.32999999999999996,524,250902
2020-07-11,152.0,110437,1640.0,97,0.32999999999999996,432,251334
2020-07-12,139.0,110509,1611.0,72,0.32999999999999996,351,251685
2020-07-13,138.0,110646,1612.0,137,0.32999999999999996,694,252379
2020-07-14,123.0,110768,1506.0,122,0.32999999999999996,661,253040
2020-07-15,136.0,110884,1489.0,116,0.32999999999999996,726,253766
2020-07-16,118.0,110998,1348.0,114,0.32999999999999996,644,254410
2020-07-17,122.0,111081,1346.0,83,0.32999999999999996,548,254958
2020-07-18,118.0,111129,1321.0,48,0.32999999999999996,473,255431
2020-07-19,119.0,111201,1301.0,72,0.32999999999999996,419,255850
2020-07-20,112.0,111287,1278.0,86,0.32999999999999996,769,256619
2020-07-21,106.0,111366,1188.0,79,0.32999999999999996,697,257316
2020-07-22,97.0,111448,1305.0,82,0.32999999999999996,764,258080
2020-07-23,101.0,111557,1095.0,109,0.32999999999999996,741,258821
2020-07-24,92.0,111650,1018.0,93,0.32999999999999996,720,259541
2020-07-25,82.0,111715,977.0,65,0.32999999999999996,499,260040
2020-07-26,81.0,111779,965.0,64,0.32999999999999996,518,260558
2020-07-27,83.0,111861,945.0,82,0.32999999999999996,824,261382
2020-07-28,78.0,111930,944.0,69,0.32999999999999996,796,262178
2020-07-29,72.0,111993,927.0,63,0.32999999999999996,994,263172
2020-07-30,70.0,112068,898.0,75,0.32999999999999996,879,264051
2020-07-31,71.0,112123,870.0,55,0.32999999999999996,644,264695
2020-08-01,74.0,112173,879.0,50,0.32999999999999996,508,265203
2020-08-02,72.0,112230,847.0,57,0.32999999999999996,518,265721
2020-08-03,67.0,112304,842.0,74,0.32999999999999996,963,266684
2020-08-04,65.0,112362,807.0,58,0.32999999999999996,965,267649
2020-08-05,63.0,112422,805.0,60,0.32999999999999996,973,268622
2020-08-06,61.0,112474,756.0,52,0.32999999999999996,1005,269627
2020-08-07,57.0,112534,711.0,60,0.32999999999999996,892,270519
2020-08-08,55.0,112612,650.0,78,0.32999999999999996,648,271167
2020-08-09,56.0,112665,611.0,53,0.32999999999999996,569,271736
2020-08-10,60.0,112715,714.0,50,0.32999999999999996,1375,273111
2020-08-11,63.0,112778,672.0,63,0.32999999999999996,1247,274358
2020-08-12,68.0,112829,642.0,51,0.32999999999999996,1126,275484
2020-08-13,64.0,112889,652.0,60,0.32999999999999996,1036,276520
2020-08-14,63.0,112944,642.0,55,0.32999999999999996,1059,277579
2020-08-15,68.0,112982,630.0,38,0.32999999999999996,656,278235
2020-08-16,69.0,113021,634.0,39,0.32999999999999996,534,278769
2020-08-17,67.0,113067,626.0,46,0.32999999999999996,1159,279928
2020-08-18,64.0,113123,597.0,56,0.32999999999999996,955,280883
2020-08-19,63.0,113181,571.0,58,0.32999999999999996,1109,281992
2020-08-20,64.0,113226,551.0,45,0.32999999999999996,1254,283246
2020-08-21,64.0,113275,528.0,49,0.32999999999999996,1031,284277
2020-08-22,66.0,113300,594.0,25,0.32999999999999996,732,285009
2020-08-23,65.0,113344,522.0,44,0.32999999999999996,704,285713
2020-08-24,62.0,113385,522.0,41,0.32999999999999996,1156,286869
2020-08-25,62.0,113445,500.0,60,0.32999999999999996,1085,287954
2020-08-26,55.0,113497,485.0,52,0.32999999999999996,1181,289135
2020-08-27,62.0,113566,492.0,69,0.32999999999999996,1356,290491
2020-08-28,52.0,113610,469.0,44,0.32999999999999996,1395,291886
2020-08-29,56.0,113662,478.0,52,0.32999999999999996,1051,292937
2020-08-30,52.0,113700,479.0,38,0.32999999999999996,987,293924
2020-08-31,54.0,113752,495.0,52,0.32999999999999996,1279,295203
2020-09-01,59.0,113810,496.0,58,0.32999999999999996,1962,297165
2020-09-02,59.0,113889,451.0,79,0.32999999999999996,2696,299861
2020-09-03,58.0,113958,468.0,69,0.32999999999999996,2716,302577
2020-09-04,54.0,114025,474.0,67,0.32999999999999996,2637,305214
2020-09-05,50.0,114119,471.0,94,0.32999999999999996,2200,307414
2020-09-06,52.0,114204,483.0,85,0.32999999999999996,2079,309493
2020-09-07,62.0,114288,555.0,84,0.32999999999999996,3530,313023
2020-09-08,64.0,114387,535.0,99,0.32999999999999996,3071,316094
2020-09-09,64.0,114523,557.0,136,0.32999999999999996,2893,318987
2020-09-10,62.0,114666,572.0,143,0.32999999999999996,3143,322130
2020-09-11,129.0,114801,622.0,135,0.32999999999999996,2893,325023
2020-09-12,70.0,114944,663.0,143,0.32999999999999996,2224,327247
2020-09-13,74.0,115097,691.0,153,0.32999999999999996,1722,328969
2020-09-14,88.0,115269,812.0,172,0.32999999999999996,2941,331910
2020-09-15,101.0,115463,891.0,194,0.32999999999999996,3057,334967
2020-09-16,107.0,115646,929.0,183,0.32999999999999996,3778,338745
2020-09-17,108.0,115845,984.0,199,0.32999999999999996,3979,342724
2020-09-18,115.0,116050,1020.0,205,0.32999999999999996,4290,347014
2020-09-19,123.0,116254,1081.0,204,0.32999999999999996,4215,351229
2020-09-20,142.0,116491,1174.0,237,0.32999999999999996,4652,355881
2020-09-21,154.0,116766,1299.0,275,0.32999999999999996,4727,360608
2020-09-22,179.0,117034,1378.0,268,0.32999999999999996,5400,366008
2020-09-23,192.0,117348,1439.0,314,0.32999999999999996,5933,371941
2020-09-24,209.0,117636,1546.0,288,0.32999999999999996,6361,378302
2020-09-25,227.0,117910,1686.0,274,0.32999999999999996,6105,384407
2020-09-26,223.0,118155,1689.0,245,0.32999999999999996,5704,390111
2020-09-27,233.0,118396,1793.0,241,0.32999999999999996,6084,396195
2020-09-28,245.0,118704,1955.0,308,0.32999999999999996,8641,404836
2020-09-29,259.0,119014,1954.0,310,0.32999999999999996,8832,413668
2020-09-30,282.0,119342,2036.0,328,0.32999999999999996,10663,424331
2020-10-01,285.0,119710,2069.0,368,0.32999999999999996,11444,435775
2020-10-02,311.0,120081,2180.0,371,0.32999999999999996,11719,447494
2020-10-03,307.0,120467,2290.0,386,0.32999999999999996,9820,457314
2020-10-04,310.0,120945,2435.0,478,0.32999999999999996,9966,467280
2020-10-05,331.0,121417,2705.0,472,0.32999999999999996,14218,481498
2020-10-06,349.0,121941,2903.0,524,0.32999999999999996,14458,495956
2020-10-07,376.0,122432,3066.0,491,0.32999999999999996,15418,511374
2020-10-08,368.0,122945,3179.0,513,0.32999999999999996,15452,526826
2020-10-09,367.0,123489,3238.0,544,0.32999999999999996,13159,539985
2020-10-10,396.0,124004,3369.0,515,0.32999999999999996,10301,550286
2020-10-11,401.0,124632,3604.0,628,0.32999999999999996,9781,560067
2020-10-12,426.0,125296,3827.0,664,0.32999999999999996,16420,576487
2020-10-13,441.0,126060,4105.0,764,0.32999999999999996,15660,592147
2020-10-14,468.0,126766,4313.0,706,0.32999999999999996,16646,608793
2020-10-15,482.0,127558,4569.0,792,0.32999999999999996,15428,624221
2020-10-16,482.0,128190,4854.0,632,0.32999999999999996,14761,638982
2020-10-17,495.0,128975,5029.0,785,0.32999999999999996,12487,651469
2020-10-18,504.0,129845,5202.0,870,0.32999999999999996,11982,663451
2020-10-19,529.0,130706,5644.0,861,0.32999999999999996,22369,685820
2020-10-20,560.0,131631,6072.0,925,0.32999999999999996,21638,707458
2020-10-21,572.0,132628,6271.0,997,0.32999999999999996,21762,729220
2020-10-22,564.0,133615,6345.0,987,0.32999999999999996,19866,749086
2020-10-23,602.0,134612,6842.0,997,0.32999999999999996,18359,767445
2020-10-24,632.0,135602,7176.0,990,0.32999999999999996,13713,781158
2020-10-25,663.0,136788,7612.0,1186,0.32999999999999996,13353,794511
2020-10-26,682.0,138067,7856.0,1279,0.32999999999999996,23033,817544
2020-10-27,743.0,139257,8595.0,1190,0.32999999999999996,20762,838306
2020-10-28,788.0,140496,9070.0,1239,0.32999999999999996,20547,858853
2020-10-29,803.0,141841,9127.0,1345,0.32999999999999996,20257,879110
2020-10-30,801.0,142950,9295.0,1109,0.32999999999999996,19899,899009
2020-10-31,816.0,144190,9782.0,1240,0.32999999999999996,14565,913574
2020-11-01,804.0,145470,9623.0,1280,0.32999999999999996,13611,927185
2020-11-02,883.0,146801,10397.0,1331,0.32999999999999996,28394,955579
2020-11-03,954.0,148047,10971.0,1246,0.32999999999999996,22690,978269
2020-11-04,997.0,149429,11037.0,1382,0.32999999999999996,21053,999322
2020-11-05,986.0,150775,10994.0,1346,0.32999999999999996,21206,1020528
2020-11-06,984.0,151957,11181.0,1182,0.32999999999999996,21179,1041707
2020-11-07,1003.0,153276,11514.0,1319,0.32999999999999996,16888,1058595
2020-11-08,1017.0,154764,11680.0,1488,0.32999999999999996,18272,1076867
2020-11-09,1048.0,156315,12259.0,1551,0.32999999999999996,28560,1105427
2020-11-10,1010.0,157907,12033.0,1592,0.32999999999999996,24836,1130263
2020-11-11,1081.0,159618,12730.0,1711,0.32999999999999996,25065,1155328
2020-11-12,1088.0,161284,12967.0,1666,0.32999999999999996,22320,1177648
2020-11-13,1158.0,162717,13328.0,1433,0.32999999999999996,22008,1199656
2020-11-14,1162.0,164105,13399.0,1388,0.32999999999999996,16290,1215946
2020-11-15,1194.0,165572,13886.0,1467,0.32999999999999996,14422,1230368
2020-11-16,1198.0,167132,14313.0,1560,0.32999999999999996,24136,1254504
2020-11-17,1228.0,168623,14411.0,1491,0.32999999999999996,20677,1275181
2020-11-18,1242.0,170194,14490.0,1571,0.32999999999999996,18545,1293726
2020-11-19,1241.0,171678,14479.0,1484,0.32999999999999996,15797,1309523
2020-11-20,1241.0,172994,14236.0,1316,0.32999999999999996,14960,1324483
2020-11-21,1248.0,174249,14118.0,1255,0.32999999999999996,10806,1335289
2020-11-22,1259.0,175582,14354.0,1333,0.32999999999999996,10216,1345505
2020-11-23,1299.0,176967,14712.0,1385,0.32999999999999996,16472,1361977
2020-11-24,1306.0,178244,14506.0,1277,0.32999999999999996,14266,1376243
2020-11-25,1300.0,179659,14240.0,1415,0.32999999999999996,14155,1390398
2020-11-26,1264.0,180857,13908.0,1198,0.32999999999999996,12459,1402857
2020-11-27,1242.0,181912,13754.0,1055,0.32999999999999996,12459,1415316
2020-11-28,1204.0,182977,13208.0,1065,0.32999999999999996,9347,1424663
2020-11-29,1214.0,184192,13521.0,1215,0.32999999999999996,9068,1433731
2020-11-30,1185.0,185408,13756.0,1216,0.32999999999999996,15228,1448959
2020-12-01,1182.0,186679,13507.0,1271,0.32999999999999996,13731,1462690
2020-12-02,1149.0,187941,13212.0,1262,0.32999999999999996,13662,1476352
2020-12-03,1094.0,189278,12896.0,1337,0.32999999999999996,12762,1489114
2020-12-04,1113.0,190526,12987.0,1248,0.32999999999999996,13065,1502179
2020-12-05,1086.0,191712,12968.0,1186,0.32999999999999996,10302,1512481
2020-12-06,1087.0,193023,13189.0,1311,0.32999999999999996,11036,1523517
2020-12-07,1109.0,194489,13616.0,1466,0.32999999999999996,17662,1541179
2020-12-08,1118.0,196017,13629.0,1528,0.32999999999999996,16937,1558116
2020-12-09,1094.0,197567,13467.0,1550,0.32999999999999996,17744,1575860
2020-12-10,1110.0,199091,13796.0,1524,0.32999999999999996,18850,1594710
2020-12-11,1117.0,200541,13901.0,1450,0.32999999999999996,20177,1614887
2020-12-12,1087.0,202128,13927.0,1587,0.32999999999999996,16268,1631155
2020-12-13,1123.0,203709,14460.0,1581,0.32999999999999996,18409,1649564
2020-12-14,1127.0,205455,15053.0,1746,0.32999999999999996,30019,1679583
2020-12-15,1159.0,207185,15031.0,1730,0.32999999999999996,29652,1709235
2020-12-16,1163.0,208981,15465.0,1796,0.32999999999999996,30650,1739885
2020-12-17,1188.0,210854,15741.0,1873,0.32999999999999996,30159,1770044
2020-12-18,1190.0,212526,15866.0,1672,0.32999999999999996,32426,1802470
2020-12-19,1239.0,214338,16183.0,1812,0.32999999999999996,22195,1824665
2020-12-20,1267.0,216314,16633.0,1976,0.32999999999999996,29556,1854221
2020-12-21,1327.0,218429,17709.0,2115,0.32999999999999996,43446,1897667
2020-12-22,1339.0,220632,18063.0,2203,0.32999999999999996,41741,1939408
2020-12-23,1374.0,222612,17834.0,1980,0.32999999999999996,38383,1977791
2020-12-24,1427.0,224407,18227.0,1795,0.32999999999999996,29287,2007078
2020-12-25,1437.0,226359,17701.0,1952,0.32999999999999996,12926,2020004
2020-12-26,1498.0,228657,18350.0,2298,0.32999999999999996,37462,2057466
2020-12-27,1556.0,231229,19277.0,2572,0.32999999999999996,43250,2100716
2020-12-28,1641.0,234024,20426.0,2795,0.32999999999999996,40845,2141561
2020-12-29,1728.0,236910,21787.0,2886,0.32999999999999996,74058,2215619
2020-12-30,1854.0,239771,22713.0,2861,0.32999999999999996,64243,2279862
2020-12-31,1899.0,242307,22728.0,2536,0.32999999999999996,47824,2327686
2021-01-01,1940.0,245317,22534.0,3010,0.32999999999999996,28879,2356565
2021-01-02,2017.0,248462,23557.0,3145,0.32999999999999996,55428,2411993
2021-01-03,2181.0,251813,24957.0,3351,0.32999999999999996,50664,2462657
2021-01-04,2310.0,255400,26626.0,3587,0.32999999999999996,70920,2533577
2021-01-05,2378.0,259097,26467.0,3697,0.32999999999999996,59600,2593177
2021-01-06,2550.0,263064,27727.0,3967,0.32999999999999996,52752,2645929
2021-01-07,2654.0,266913,28246.0,3849,0.32999999999999996,48132,2694061
2021-01-08,2814.0,270462,29346.0,3549,0.32999999999999996,43494,2737555
2021-01-09,2860.0,274180,29462.0,3718,0.32999999999999996,36419,2773974
2021-01-10,2963.0,277751,30758.0,3571,0.32999999999999996,33749,2807723
2021-01-11,3055.0,281645,32070.0,3894,0.32999999999999996,53519,2861242
2021-01-12,3175.0,285779,32202.0,4134,0.32999999999999996,45968,2907210
2021-01-13,3307.0,289619,32689.0,3840,0.32999999999999996,42303,2949513
2021-01-14,3351.0,293297,32925.0,3678,0.32999999999999996,39658,2989171
2021-01-15,3464.0,296592,33362.0,3295,0.32999999999999996,37879,3027050
2021-01-16,3525.0,300161,32923.0,3569,0.32999999999999996,28413,3055463
2021-01-17,3533.0,303585,33352.0,3424,0.32999999999999996,26976,3082439
2021-01-18,3570.0,307296,34336.0,3711,0.32999999999999996,41935,3124374
2021-01-19,3603.0,311064,34015.0,3768,0.32999999999999996,37055,3161429
2021-01-20,3603.0,314743,33886.0,3679,0.32999999999999996,32679,3194108
2021-01-21,3607.0,317980,33235.0,3237,0.32999999999999996,29633,3223741
2021-01-22,3727.0,320996,33412.0,3016,0.32999999999999996,27741,3251482
2021-01-23,3731.0,323776,32614.0,2780,0.32999999999999996,20425,3271907
2021-01-24,3736.0,326600,32907.0,2824,0.32999999999999996,15883,3287790
2021-01-25,3694.0,329248,32938.0,2648,0.32999999999999996,27972,3315762
2021-01-26,3634.0,332047,32337.0,2799,0.32999999999999996,25210,3340972
2021-01-27,3602.0,334789,30846.0,2742,0.32999999999999996,23899,3364871
2021-01-28,3585.0,337508,30333.0,2719,0.32999999999999996,22523,3387394
2021-01-29,3506.0,339887,29359.0,2379,0.32999999999999996,20363,3407757
2021-01-30,3486.0,342080,28571.0,2193,0.32999999999999996,15524,3423281
2021-01-31,3366.0,344263,28112.0,2183,0.32999999999999996,14138,3437419
2021-02-01,3414.0,346610,28539.0,2347,0.3086325,20765,3458184
2021-02-02,3324.0,348832,27397.0,2222,0.3086325,18193,3476377
2021-02-03,3328.0,350928,26374.0,2096,0.3086325,17948,3494325
2021-02-04,3275.0,352835,25334.0,1907,0.3086325,16717,3511042
2021-02-05,3217.0,354592,24402.0,1757,0.3086325,14461,3525503
2021-02-06,3099.0,356271,23042.0,1679,0.3086325,10951,3536454
2021-02-07,3047.0,357946,22991.0,1675,0.3086325,10457,3546911
2021-02-08,2980.0,359685,23020.0,1739,0.3086325,14370,3561281
2021-02-09,2911.0,361216,22067.0,1531,0.3086325,12696,3573977
2021-02-10,2872.0,362751,20926.0,1535,0.3086325,12272,3586249
2021-02-11,2780.0,364191,19983.0,1440,0.3086325,11637,3597886
2021-02-12,2688.0,365509,19009.0,1318,0.3086325,10986,3608872
2021-02-13,2592.0,366749,17694.0,1240,0.3086325,8025,3616897
2021-02-14,2611.0,368113,17787.0,1364,0.3086325,7781,3624678
2021-02-15,2577.0,369435,17730.0,1322,0.3086325,12953,3637631
2021-02-16,2484.0,370746,17093.0,1311,0.3086325,11268,3648899
2021-02-17,2393.0,371979,16458.0,1233,0.3086325,10419,3659318
2021-02-18,2316.0,373128,15633.0,1149,0.3086325,10303,3669621
2021-02-19,2251.0,374196,15018.0,1068,0.3086325,9246,3678867
2021-02-20,2142.0,375100,14316.0,904,0.3086325,7161,3686028
2021-02-21,2122.0,376108,14142.0,1008,0.3086325,7033,3693061
2021-02-22,2072.0,377088,14137.0,980,0.3086325,10279,3703340
2021-02-23,1950.0,378064,13489.0,976,0.3086325,8536,3711876
2021-02-24,1931.0,378938,13007.0,874,0.3086325,7621,3719497
2021-02-25,1866.0,379770,12449.0,832,0.3086325,6934,3726431
2021-02-26,1808.0,380488,11781.0,718,0.3086325,5883,3732314
2021-02-27,1747.0,381112,11090.0,624,0.3086325,4254,3736568
2021-02-28,1630.0,381774,10663.0,662,0.3086325,4112,3740680
2021-03-01,1658.0,382478,10765.0,704,0.287265,6215,3746895
2021-03-02,1556.0,383161,10121.0,683,0.287265,5950,3752845
2021-03-03,1507.0,383768,9594.0,607,0.287265,5305,3758150
2021-03-04,1454.0,384364,9092.0,596,0.287265,5011,3763161
2021-03-05,1417.0,384851,8594.0,487,0.287265,4728,3767889
2021-03-06,1326.0,385379,8021.0,528,0.287265,3832,3771721
2021-03-07,1273.0,385840,7812.0,461,0.287265,3677,3775398
2021-03-08,1236.0,386341,7847.0,501,0.287265,5818,3781216
2021-03-09,1187.0,386824,7451.0,483,0.287265,5488,3786704
2021-03-10,1137.0,387318,6975.0,494,0.287265,5222,3791926
2021-03-11,1101.0,387767,6687.0,449,0.287265,4848,3796774
2021-03-12,1023.0,388153,6391.0,386,0.287265,4767,3801541
2021-03-13,1000.0,388538,6072.0,385,0.287265,3592,3805133
2021-03-14,963.0,388895,6039.0,357,0.287265,3707,3808840
2021-03-15,930.0,389326,5976.0,431,0.287265,5643,3814483
2021-03-16,882.0,389690,5664.0,364,0.287265,4933,3819416
2021-03-17,846.0,390033,5397.0,343,0.287265,5048,3824464
2021-03-18,797.0,390384,5083.0,351,0.287265,4689,3829153
2021-03-19,749.0,390667,4841.0,283,0.287265,4333,3833486
2021-03-20,710.0,390954,4589.0,287,0.287265,3514,3837000
2021-03-21,692.0,391233,4492.0,279,0.287265,4679,3841679
2021-03-22,676.0,391527,4501.0,294,0.287265,5400,3847079
2021-03-23,647.0,391822,4245.0,295,0.287265,4566,3851645
2021-03-24,613.0,392099,4005.0,277,0.287265,5321,3856966
2021-03-25,566.0,392387,3763.0,288,0.287265,4674,3861640
2021-03-26,559.0,392632,3712.0,245,0.287265,3803,3865443
2021-03-27,537.0,392849,3676.0,217,0.287265,3136,3868579
2021-03-28,532.0,393070,3438.0,221,0.287265,4477,3873056
2021-03-29,532.0,393276,3466.0,206,0.287265,3422,3876478
2021-03-30,518.0,393493,3283.0,217,0.287265,3135,3879613
2021-03-31,501.0,393718,3084.0,225,0.287265,3340,3882953
2021-04-01,470.0,393898,2928.0,180,0.26589749999999995,3067,3886020
2021-04-02,436.0,394076,2784.0,178,0.26589749999999995,2248,3888268
2021-04-03,433.0,394255,2677.0,179,0.26589749999999995,2121,3890389
2021-04-04,422.0,394411,2672.0,156,0.26589749999999995,2042,3892431
2021-04-05,416.0,394599,2680.0,188,0.26589749999999995,2314,3894745
2021-04-06,406.0,394782,2588.0,183,0.26589749999999995,2756,3897501
2021-04-07,393.0,394971,2486.0,189,0.26589749999999995,2752,3900253
2021-04-08,377.0,395138,2382.0,167,0.26589749999999995,2651,3902904
2021-04-09,362.0,395305,2321.0,167,0.26589749999999995,2482,3905386
2021-04-10,342.0,395456,2190.0,151,0.26589749999999995,2009,3907395
2021-04-11,343.0,395631,2096.0,175,0.26589749999999995,2020,3909415
2021-04-12,337.0,395804,2108.0,173,0.26589749999999995,2399,3911814
2021-04-13,333.0,395957,2057.0,153,0.26589749999999995,2060,3913874
2021-04-14,315.0,396113,1972.0,156,0.26589749999999995,2068,3915942
2021-04-15,294.0,396240,1885.0,127,0.26589749999999995,1959,3917901
2021-04-16,298.0,396358,1844.0,118,0.26589749999999995,1963,3919864
2021-04-17,292.0,396493,1735.0,135,0.26589749999999995,1398,3921262
2021-04-18,283.0,396605,1691.0,112,0.26589749999999995,2281,3923543
2021-04-19,291.0,396743,1732.0,138,0.26589749999999995,2268,3925811
2021-04-20,273.0,396841,1649.0,98,0.26589749999999995,2112,3927923
2021-04-21,249.0,396967,1609.0,126,0.26589749999999995,2298,3930221
2021-04-22,237.0,397059,1523.0,92,0.26589749999999995,2032,3932253
2021-04-23,221.0,397183,1478.0,124,0.26589749999999995,1701,3933954
2021-04-24,220.0,397282,1401.0,99,0.26589749999999995,1300,3935254
2021-04-25,211.0,397389,1377.0,107,0.26589749999999995,1897,3937151
2021-04-26,208.0,397497,1393.0,108,0.26589749999999995,2267,3939418
2021-04-27,196.0,397625,1310.0,128,0.26589749999999995,1809,3941227
2021-04-28,188.0,397714,1278.0,89,0.26589749999999995,2153,3943380
2021-04-29,178.0,397794,1235.0,80,0.26589749999999995,1901,3945281
2021-04-30,170.0,397876,1161.0,82,0.26589749999999995,1528,3946809
2021-05-01,167.0,397944,1071.0,68,0.24453,1211,3948020
2021-05-02,172.0,398036,1082.0,92,0.24453,1305,3949325
2021-05-03,168.0,398134,1096.0,98,0.24453,1806,3951131
2021-05-04,162.0,398210,1093.0,76,0.24453,2200,3953331
2021-05-05,161.0,398306,1032.0,96,0.24453,2203,3955534
2021-05-06,144.0,398394,976.0,88,0.24453,1967,3957501
2021-05-07,145.0,398471,973.0,77,0.24453,1657,3959158
2021-05-08,135.0,398551,948.0,80,0.24453,1301,3960459
2021-05-09,131.0,398627,933.0,76,0.24453,1985,3962444
2021-05-10,135.0,398703,944.0,76,0.24453,2325,3964769
2021-05-11,126.0,398782,921.0,79,0.24453,1872,3966641
2021-05-12,123.0,398875,907.0,93,0.24453,1869,3968510
2021-05-13,119.0,398949,845.0,74,0.24453,1737,3970247
2021-05-14,115.0,399021,818.0,72,0.24453,1540,3971787
2021-05-15,115.0,399091,810.0,70,0.24453,1306,3973093
2021-05-16,116.0,399150,801.0,59,0.24453,1587,3974680
2021-05-17,117.0,399224,798.0,74,0.24453,2341,3977021
2021-05-18,114.0,399314,749.0,90,0.24453,2241,3979262
2021-05-19,113.0,399407,757.0,93,0.24453,2261,3981523
2021-05-20,115.0,399505,749.0,98,0.24453,2000,3983523
2021-05-21,117.0,399590,766.0,85,0.24453,1872,3985395
2021-05-22,113.0,399665,730.0,75,0.24453,1606,3987001
2021-05-23,111.0,399742,756.0,77,0.24453,1918,3988919
2021-05-24,113.0,399840,797.0,98,0.24453,2750,3991669
2021-05-25,117.0,399928,765.0,88,0.24453,2797,3994466
2021-05-26,115.0,400023,745.0,95,0.24453,3179,3997645
2021-05-27,110.0,400106,742.0,83,0.24453,3075,4000720
2021-05-28,116.0,400198,743.0,92,0.24453,2929,4003649
2021-05-29,112.0,400267,748.0,69,0.24453,2462,4006111
2021-05-30,115.0,400347,755.0,80,0.24453,2598,4008709
2021-05-31,110.0,400445,773.0,98,0.24453,3170,4011879
2021-06-01,123.0,400560,776.0,115,0.22316249999999999,4515,4016394
2021-06-02,116.0,400661,801.0,101,0.22316249999999999,5039,4021433
2021-06-03,124.0,400754,779.0,93,0.22316249999999999,5131,4026564
2021-06-04,119.0,400850,805.0,96,0.22316249999999999,4886,4031450
2021-06-05,124.0,400946,782.0,96,0.22316249999999999,3964,4035414
2021-06-06,131.0,401067,807.0,121,0.22316249999999999,4730,4040144
2021-06-07,133.0,401198,860.0,131,0.22316249999999999,6791,4046935
2021-06-08,140.0,401345,879.0,147,0.22316249999999999,6630,4053565
2021-06-09,141.0,401503,876.0,158,0.22316249999999999,6919,4060484
2021-06-10,140.0,401665,906.0,162,0.22316249999999999,6718,4067202
2021-06-11,146.0,401809,884.0,144,0.22316249999999999,6510,4073712
2021-06-12,152.0,401946,915.0,137,0.22316249999999999,5422,4079134
2021-06-13,171.0,402133,947.0,187,0.22316249999999999,6075,4085209
2021-06-14,170.0,402318,993.0,185,0.22316249999999999,8941,4094150
2021-06-15,187.0,402506,1030.0,188,0.22316249999999999,9153,4103303
2021-06-16,192.0,402683,1057.0,177,0.22316249999999999,9411,4112714
2021-06-17,197.0,402885,1122.0,202,0.22316249999999999,9523,4122237
2021-06-18,210.0,403070,1170.0,185,0.22316249999999999,8772,4131009
2021-06-19,203.0,403248,1143.0,178,0.22316249999999999,7127,4138136
2021-06-20,196.0,403419,1168.0,171,0.22316249999999999,8203,4146339
2021-06-21,212.0,403600,1290.0,181,0.22316249999999999,12707,4159046
2021-06-22,229.0,403782,1301.0,182,0.22316249999999999,13563,4172609
2021-06-23,227.0,403996,1255.0,214,0.22316249999999999,14806,4187415
2021-06-24,240.0,404190,1274.0,194,0.22316249999999999,15084,4202499
2021-06-25,238.0,404396,1284.0,206,0.22316249999999999,14901,4217400
2021-06-26,236.0,404619,1276.0,223,0.22316249999999999,13486,4230886
2021-06-27,244.0,404845,1331.0,226,0.22316249999999999,15407,4246293
2021-06-28,272.0,405089,1465.0,244,0.22316249999999999,23511,4269804
2021-06-29,259.0,405372,1445.0,283,0.22316249999999999,23250,4293054
2021-06-30,264.0,405703,1500.0,331,0.22316249999999999,23941,4316995
2021-07-01,279.0,405998,1560.0,295,0.201795,24267,4341262
2021-07-02,297.0,406305,1611.0,307,0.201795,22287,4363549
2021-07-03,296.0,406628,1636.0,323,0.201795,20638,4384187
2021-07-04,305.0,407018,1744.0,390,0.201795,21806,4405993
2021-07-05,330.0,407434,1888.0,416,0.201795,30215,4436208
2021-07-06,353.0,407892,1998.0,458,0.201795,31627,4467835
2021-07-07,377.0,408353,2144.0,461,0.201795,34274,4502109
2021-07-08,376.0,408841,2209.0,488,0.201795,29929,4532038
2021-07-09,393.0,409292,2352.0,451,0.201795,29050,4561088
2021-07-10,398.0,409734,2429.0,442,0.201795,25411,4586499
2021-07-11,408.0,410236,2564.0,502,0.201795,27418,4613917
2021-07-12,433.0,410846,2798.0,610,0.201795,40477,4654394
2021-07-13,470.0,411467,2970.0,621,0.201795,43247,4697641
2021-07-14,489.0,412103,3110.0,636,0.201795,50320,4747961
2021-07-15,493.0,412761,3241.0,658,0.201795,57583,4805544
2021-07-16,512.0,413354,3367.0,593,0.201795,51138,4856682
2021-07-17,514.0,413976,3442.0,622,0.201795,35281,4891963
2021-07-18,512.0,414674,3546.0,698,0.201795,33164,4925127
2021-07-19,543.0,415426,3813.0,752,0.201795,43401,4968528
2021-07-20,544.0,416231,3894.0,805,0.201795,35947,5004475
2021-07-21,567.0,417014,4063.0,783,0.201795,31676,5036151
2021-07-22,612.0,417841,4230.0,827,0.201795,27711,5063862
2021-07-23,625.0,418566,4401.0,725,0.201795,24586,5088448
2021-07-24,659.0,419300,4476.0,734,0.201795,20276,5108724
2021-07-25,675.0,420136,4725.0,836,0.201795,19657,5128381
2021-07-26,712.0,420966,5055.0,830,0.201795,26541,5154922
2021-07-27,738.0,421782,5163.0,816,0.201795,26027,5180949
2021-07-28,748.0,422510,5182.0,728,0.201795,26925,5207874
2021-07-29,765.0,423268,5056.0,758,0.201795,25361,5233235
2021-07-30,785.0,423918,5111.0,650,0.201795,22109,5255344
2021-07-31,789.0,424511,5057.0,593,0.201795,18450,5273794
2021-08-01,769.0,425156,5090.0,645,0.18042750000000002,18714,5292508
2021-08-02,791.0,425842,5309.0,686,0.18042750000000002,26580,5319088
2021-08-03,780.0,426522,5116.0,680,0.18042750000000002,27062,5346150
2021-08-04,772.0,427269,4944.0,747,0.18042750000000002,28895,5375045
2021-08-05,770.0,427962,4894.0,693,0.18042750000000002,28126,5403171
2021-08-06,765.0,428619,4879.0,657,0.18042750000000002,24851,5428022
2021-08-07,760.0,429249,4817.0,630,0.18042750000000002,19957,5447979
2021-08-08,765.0,429900,4939.0,651,0.18042750000000002,20157,5468136
2021-08-09,762.0,430565,5098.0,665,0.18042750000000002,28292,5496428
2021-08-10,782.0,431325,5096.0,760,0.18042750000000002,27610,5524038
2021-08-11,777.0,432072,5073.0,747,0.18042750000000002,29135,5553173
2021-08-12,783.0,432830,5029.0,758,0.18042750000000002,27690,5580863
2021-08-13,793.0,433524,5076.0,694,0.18042750000000002,24992,5605855
2021-08-14,797.0,434213,4973.0,689,0.18042750000000002,21336,5627191
2021-08-15,800.0,434932,5115.0,719,0.18042750000000002,21280,5648471
2021-08-16,816.0,435708,5429.0,776,0.18042750000000002,30861,5679332
2021-08-17,825.0,436540,5437.0,832,0.18042750000000002,31095,5710427
2021-08-18,812.0,437335,5514.0,795,0.18042750000000002,31426,5741853
2021-08-19,835.0,438159,5554.0,824,0.18042750000000002,29081,5770934
2021-08-20,857.0,438892,5576.0,733,0.18042750000000002,25555,5796489
2021-08-21,858.0,439649,5575.0,757,0.18042750000000002,22605,5819094
2021-08-22,863.0,440375,5749.0,726,0.18042750000000002,22409,5841503
2021-08-23,845.0,441206,6000.0,831,0.18042750000000002,30333,5871836
2021-08-24,857.0,442024,5911.0,818,0.18042750000000002,28212,5900048
2021-08-25,871.0,442867,5922.0,843,0.18042750000000002,27901,5927949
2021-08-26,872.0,443644,5893.0,777,0.18042750000000002,26482,5954431
2021-08-27,874.0,444393,5889.0,749,0.18042750000000002,24253,5978684
2021-08-28,835.0,445081,5756.0,688,0.18042750000000002,20138,5998822
2021-08-29,850.0,445782,5855.0,701,0.18042750000000002,19152,6017974
2021-08-30,859.0,446590,6002.0,808,0.18042750000000002,24973,6042947
2021-08-31,879.0,447388,6293.0,798,0.18042750000000002,33565,6076512
2021-09-01,890.0,448223,6236.0,835,0.15906,31600,6108112
2021-09-02,897.0,449011,6186.0,788,0.15906,30636,6138748
2021-09-03,889.0,449699,6195.0,688,0.15906,28730,6167478
2021-09-04,880.0,450451,6043.0,752,0.15906,23409,6190887
2021-09-05,878.0,451142,6167.0,691,0.15906,23457,6214344
2021-09-06,909.0,451973,6375.0,831,0.15906,33135,6247479
2021-09-07,885.0,452774,6244.0,801,0.15906,27938,6275417
2021-09-08,896.0,453674,6302.0,900,0.15906,25659,6301076
2021-09-09,887.0,454464,6254.0,790,0.15906,24440,6325516
2021-09-10,898.0,455144,6400.0,680,0.15906,21031,6346547
2021-09-11,865.0,455793,6206.0,649,0.15906,16956,6363503
2021-09-12,884.0,456451,6253.0,658,0.15906,17879,6381382
2021-09-13,886.0,457139,6424.0,688,0.15906,25199,6406581
2021-09-14,888.0,457840,6344.0,701,0.15906,22641,6429222
2021-09-15,910.0,458531,6306.0,691,0.15906,22414,6451636
2021-09-16,849.0,459203,6081.0,672,0.15906,22320,6473956
2021-09-17,844.0,459743,5910.0,540,0.15906,22375,6496331
2021-09-18,829.0,460303,5688.0,560,0.15906,20926,6517257
2021-09-19,824.0,460875,5695.0,572,0.15906,24789,6542046
2021-09-20,811.0,461481,5727.0,606,0.15906,32121,6574167
2021-09-21,774.0,462083,5543.0,602,0.15906,30547,6604714
2021-09-22,783.0,462655,5406.0,572,0.15906,28789,6633503
2021-09-23,757.0,463232,5214.0,577,0.15906,28340,6661843
2021-09-24,730.0,463789,5036.0,557,0.15906,25754,6687597
2021-09-25,723.0,464309,5100.0,520,0.15906,23389,6710986
2021-09-26,689.0,464844,4949.0,535,0.15906,26814,6737800
2021-09-27,685.0,465461,5121.0,617,0.15906,34595,6772395
2021-09-28,681.0,466057,5126.0,596,0.15906,29628,6802023
2021-09-29,671.0,466682,5017.0,625,0.15906,28688,6830711
2021-09-30,672.0,467234,4916.0,552,0.15906,26808,6857519
2021-10-01,671.0,467754,4799.0,520,0.13769250000000005,24134,6881653
2021-10-02,630.0,468303,4652.0,549,0.13769250000000005,21873,6903526
2021-10-03,639.0,468880,4778.0,577,0.13769250000000005,27138,6930664
2021-10-04,632.0,469507,4909.0,627,0.13769250000000005,36475,6967139
2021-10-05,661.0,470165,5006.0,658,0.13769250000000005,32269,6999408
2021-10-06,663.0,470797,5009.0,632,0.13769250000000005,32547,7031955
2021-10-07,665.0,471431,4962.0,634,0.13769250000000005,32158,7064113
2021-10-08,647.0,472050,4975.0,619,0.13769250000000005,29848,7093961
2021-10-09,639.0,472663,4921.0,613,0.13769250000000005,27180,7121141
2021-10-10,622.0,473269,5077.0,606,0.13769250000000005,31499,7152640
2021-10-11,621.0,473954,5206.0,685,0.13769250000000005,43115,7195755
2021-10-12,657.0,474714,5213.0,760,0.13769250000000005,40892,7236647
2021-10-13,657.0,475466,5246.0,752,0.13769250000000005,40547,7277194
2021-10-14,655.0,476196,5289.0,730,0.13769250000000005,39262,7316456
2021-10-15,673.0,476948,5363.0,752,0.13769250000000005,36631,7353087
2021-10-16,681.0,477691,5385.0,743,0.13769250000000005,31639,7384726
2021-10-17,695.0,478519,5623.0,828,0.13769250000000005,37501,7422227
2021-10-18,703.0,479415,5938.0,896,0.13769250000000005,49257,7471484
2021-10-19,733.0,480309,6099.0,894,0.13769250000000005,44630,7516114
2021-10-20,746.0,481212,6299.0,903,0.13769250000000005,43963,7560077
2021-10-21,750.0,482011,6366.0,799,0.13769250000000005,38581,7598658
2021-10-22,746.0,482771,6405.0,760,0.13769250000000005,34506,7633164
2021-10-23,728.0,483527,6386.0,756,0.13769250000000005,29747,7662911
2021-10-24,745.0,484356,6515.0,829,0.13769250000000005,30091,7693002
2021-10-25,776.0,485221,6801.0,865,0.13769250000000005,39958,7732960
2021-10-26,803.0,486132,6883.0,911,0.13769250000000005,35276,7768236
2021-10-27,799.0,487087,6951.0,955,0.13769250000000005,36524,7804760
2021-10-28,794.0,487975,7019.0,888,0.13769250000000005,35076,7839836
2021-10-29,809.0,488815,7113.0,840,0.13769250000000005,33995,7873831
2021-10-30,812.0,489556,7155.0,741,0.13769250000000005,28243,7902074
2021-10-31,815.0,490416,7311.0,860,0.13769250000000005,29564,7931638
2021-11-01,859.0,491315,7535.0,899,0.11632500000000004,37663,7969301
2021-11-02,859.0,492206,7510.0,891,0.11632500000000004,31328,8000629
2021-11-03,854.0,493013,7291.0,807,0.11632500000000004,29396,8030025
2021-11-04,867.0,493730,7201.0,717,0.11632500000000004,27379,8057404
2021-11-05,860.0,494416,7072.0,686,0.11632500000000004,24405,8081809
2021-11-06,856.0,495104,6874.0,688,0.11632500000000004,22581,8104390
2021-11-07,846.0,495843,6910.0,739,0.11632500000000004,25447,8129837
2021-11-08,869.0,496693,7075.0,850,0.11632500000000004,36138,8165975
2021-11-09,865.0,497501,7053.0,808,0.11632500000000004,34679,8200654
2021-11-10,846.0,498322,6961.0,821,0.11632500000000004,35390,8236044
2021-11-11,842.0,499119,6861.0,797,0.11632500000000004,33700,8269744
2021-11-12,838.0,499848,6777.0,729,0.11632500000000004,31337,8301081
2021-11-13,830.0,500503,6639.0,655,0.11632500000000004,27358,8328439
2021-11-14,841.0,501181,6707.0,678,0.11632500000000004,29599,8358038
2021-11-15,821.0,501876,6864.0,695,0.11632500000000004,42477,8400515
2021-11-16,796.0,502589,6623.0,713,0.11632500000000004,38656,8439171
2021-11-17,792.0,503316,6412.0,727,0.11632500000000004,38257,8477428
2021-11-18,779.0,504013,6336.0,697,0.11632500000000004,37099,8514527
2021-11-19,769.0,504650,6310.0,637,0.11632500000000004,33184,8547711
2021-11-20,764.0,505261,6191.0,611,0.11632500000000004,29868,8577579
2021-11-21,776.0,505909,6322.0,648,0.11632500000000004,31761,8609340
2021-11-22,785.0,506511,6424.0,602,0.11632500000000004,42869,8652209
2021-11-23,780.0,507170,6257.0,659,0.11632500000000004,41015,8693224
2021-11-24,783.0,507922,6062.0,752,0.11632500000000004,39881,8733105
2021-11-25,790.0,508572,6068.0,650,0.11632500000000004,37143,8770248
2021-11-26,796.0,509192,5992.0,620,0.11632500000000004,33666,8803914
2021-11-27,787.0,509801,5852.0,609,0.11632500000000004,28459,8832373
2021-11-28,793.0,510408,5890.0,607,0.11632500000000004,33857,8866230
2021-11-29,793.0,511077,6094.0,669,0.11632500000000004,47939,8914169
2021-11-30,806.0,511776,6123.0,699,0.11632500000000004,47632,8961801
2021-12-01,773.0,512474,5829.0,698,0.0949575,47263,9009064
2021-12-02,774.0,513193,5915.0,719,0.0949575,43045,9052109
2021-12-03,783.0,513817,5851.0,624,0.0949575,39222,9091331
2021-12-04,775.0,514452,5784.0,635,0.0949575,33379,9124710
2021-12-05,770.0,515180,5903.0,728,0.0949575,35037,9159747
2021-12-06,793.0,515916,5992.0,736,0.0949575,51123,9210870
2021-12-07,779.0,516715,6027.0,799,0.0949575,48146,9259016
2021-12-08,778.0,517469,6053.0,754,0.0949575,50059,9309075
2021-12-09,792.0,518268,6130.0,799,0.0949575,48817,9357892
2021-12-10,793.0,518975,6088.0,707,0.0949575,45018,9402910
2021-12-11,785.0,519671,6095.0,696,0.0949575,41940,9444850
2021-12-12,788.0,520443,6223.0,772,0.0949575,46367,9491217
2021-12-13,795.0,521237,6395.0,794,0.0949575,76507,9567724
2021-12-14,795.0,522052,6434.0,815,0.0949575,90717,9658441
2021-12-15,786.0,522857,6358.0,805,0.0949575,99654,9758095
2021-12-16,783.0,523634,6405.0,777,0.0949575,93804,9851899
2021-12-17,789.0,524377,6321.0,743,0.0949575,84967,9936866
2021-12-18,767.0,525112,6287.0,735,0.0949575,78930,10015796
2021-12-19,767.0,526038,6434.0,926,0.0949575,78497,10094293
2021-12-20,768.0,527099,6688.0,1061,0.0949575,117577,10211870
2021-12-21,757.0,528197,6902.0,1098,0.0949575,129599,10341469
2021-12-22,745.0,529443,7080.0,1246,0.0949575,138142,10479611
2021-12-23,747.0,530695,7114.0,1252,0.0949575,137021,10616632
2021-12-24,742.0,531715,7366.0,1020,0.0949575,117562,10734194
2021-12-25,745.0,532996,7166.0,1281,0.0949575,59912,10794106
2021-12-26,758.0,534370,7536.0,1374,0.0949575,98918,10893024
2021-12-27,776.0,536121,8474.0,1751,0.0949575,155567,11048591
2021-12-28,758.0,538203,9546.0,2082,0.0949575,170586,11219177
2021-12-29,771.0,540573,10462.0,2370,0.0949575,224031,11443208
2021-12-30,782.0,542687,11452.0,2114,0.0949575,192825,11636033
2021-12-31,789.0,544468,12395.0,1781,0.0949575,152887,11788920
2022-01-01,765.0,546287,12615.0,1819,0.07359,99303,11888223
2022-01-02,769.0,548168,13151.0,1881,0.07359,148609,12036832
2022-01-03,777.0,550387,14210.0,2219,0.07359,193617,12230449
2022-01-04,797.0,552488,15044.0,2101,0.07359,234873,12465322
2022-01-05,769.0,554627,15659.0,2139,0.07359,183798,12649120
2022-01-06,762.0,556670,16058.0,2043,0.07359,150786,12799906
2022-01-07,728.0,558442,16163.0,1772,0.07359,105080,12904986
2022-01-08,708.0,560304,16034.0,1862,0.07359,81221,12986207
2022-01-09,704.0,562279,16399.0,1975,0.07359,83081,13069288
2022-01-10,707.0,564459,17120.0,2180,0.07359,116343,13185631
2022-01-11,686.0,566586,16939.0,2127,0.07359,100979,13286610
2022-01-12,672.0,568541,16881.0,1955,0.07359,90000,13376610
2022-01-13,666.0,570457,16716.0,1916,0.07359,84132,13460742
2022-01-14,637.0,572149,16537.0,1692,0.07359,75174,13535916
2022-01-15,608.0,573753,16281.0,1604,0.07359,67821,13603737
2022-01-16,619.0,575521,16372.0,1768,0.07359,85599,13689336
2022-01-17,623.0,577329,16621.0,1808,0.07359,114776,13804112
2022-01-18,614.0,579123,16218.0,1794,0.07359,103308,13907420
2022-01-19,586.0,580901,15742.0,1778,0.07359,97335,14004755
2022-01-20,573.0,582599,15302.0,1698,0.07359,86951,14091706
2022-01-21,552.0,584052,14865.0,1453,0.07359,79172,14170878
2022-01-22,545.0,585329,14320.0,1277,0.07359,70483,14241361
2022-01-23,524.0,586864,14334.0,1535,0.07359,88558,14329919
2022-01-24,521.0,588457,14563.0,1593,0.07359,109233,14439152
2022-01-25,501.0,590138,14088.0,1681,0.07359,96955,14536107
2022-01-26,493.0,591827,13948.0,1689,0.07359,93211,14629318
2022-01-27,481.0,593330,13651.0,1503,0.07359,82726,14712044
2022-01-28,467.0,594672,13462.0,1342,0.07359,71682,14783726
2022-01-29,458.0,595997,12672.0,1325,0.07359,63024,14846750
2022-01-30,457.0,597282,12992.0,1285,0.07359,74980,14921730
2022-01-31,449.0,598733,13331.0,1451,0.07359,88502,15010232
2022-02-01,449.0,600270,12896.0,1537,0.0522225,78511,15088743
2022-02-02,432.0,601721,12577.0,1451,0.0522225,73908,15162651
2022-02-03,429.0,603013,12423.0,1292,0.0522225,64032,15226683
2022-02-04,425.0,604199,12032.0,1186,0.0522225,52556,15279239
2022-02-05,409.0,605276,11604.0,1077,0.0522225,43233,15322472
2022-02-06,391.0,606487,11529.0,1211,0.0522225,50148,15372620
2022-02-07,395.0,607721,11710.0,1234,0.0522225,62672,15435292
2022-02-08,385.0,608987,11471.0,1266,0.0522225,55437,15490729
2022-02-09,384.0,610207,11071.0,1220,0.0522225,51013,15541742
2022-02-10,384.0,611374,10734.0,1167,0.0522225,41331,15583073
2022-02-11,372.0,612370,10367.0,996,0.0522225,34944,15618017
2022-02-12,360.0,613359,10010.0,989,0.0522225,29142,15647159
2022-02-13,348.0,614388,10049.0,1029,0.0522225,32326,15679485
2022-02-14,355.0,615520,10273.0,1132,0.0522225,42490,15721975
2022-02-15,323.0,616664,10019.0,1144,0.0522225,40145,15762120
2022-02-16,326.0,617784,9804.0,1120,0.0522225,39445,15801565
2022-02-17,303.0,618755,9600.0,971,0.0522225,34168,15835733
2022-02-18,303.0,619655,9258.0,900,0.0522225,24923,15860656
2022-02-19,296.0,620489,9187.0,834,0.0522225,26429,15887085
2022-02-20,304.0,621460,9058.0,971,0.0522225,28411,15915496
2022-02-21,292.0,622490,9229.0,1030,0.0522225,33033,15948529
2022-02-22,284.0,623466,8948.0,976,0.0522225,28019,15976548
2022-02-23,278.0,624442,8868.0,976,0.0522225,26009,16002557
2022-02-24,262.0,625426,8645.0,984,0.0522225,21882,16024439
2022-02-25,246.0,626267,8498.0,841,0.0522225,19533,16043972
2022-02-26,226.0,627155,8197.0,888,0.0522225,17604,16061576
2022-02-27,239.0,628104,8305.0,949,0.0522225,22165,16083741
2022-02-28,254.0,629249,8538.0,1145,0.0522225,31865,16115606
2022-03-01,245.0,630360,8486.0,1111,0.030855,31864,16147470
2022-03-02,249.0,631544,8402.0,1184,0.030855,33361,16180831
2022-03-03,234.0,632770,8210.0,1226,0.030855,31533,16212364
2022-03-04,232.0,633814,8403.0,1044,0.030855,30605,16242969
2022-03-05,231.0,634864,8400.0,1050,0.030855,28509,16271478
2022-03-06,234.0,636124,8502.0,1260,0.030855,35914,16307392
2022-03-07,239.0,637402,8923.0,1278,0.030855,50982,16358374
2022-03-08,242.0,638791,9176.0,1389,0.030855,52342,16410716
2022-03-09,235.0,640312,9163.0,1521,0.030855,55491,16466207
2022-03-10,221.0,641726,9241.0,1414,0.030855,54298,16520505
2022-03-11,221.0,643138,9369.0,1412,0.030855,52270,16572775
2022-03-12,216.0,644506,9618.0,1368,0.030855,49161,16621936
2022-03-13,215.0,646097,9908.0,1591,0.030855,60270,16682206
2022-03-14,239.0,647748,10576.0,1651,0.030855,79517,16761723
2022-03-15,235.0,649548,10877.0,1800,0.030855,74101,16835824
2022-03-16,236.0,651371,11010.0,1823,0.030855,73952,16909776
2022-03-17,249.0,653109,11346.0,1738,0.030855,67687,16977463
2022-03-18,240.0,654738,11595.0,1629,0.030855,61904,17039367
2022-03-19,231.0,656551,11638.0,1813,0.030855,55211,17094578
2022-03-20,237.0,658344,12070.0,1793,0.030855,66907,17161485
2022-03-21,252.0,660328,12753.0,1984,0.030855,89907,17251392
2022-03-22,269.0,662426,13060.0,2098,0.030855,81845,17333237
2022-03-23,260.0,664563,13248.0,2137,0.030855,77600,17410837
2022-03-24,286.0,666569,13602.0,2006,0.030855,68604,17479441
2022-03-25,290.0,668494,13842.0,1925,0.030855,60256,17539697
2022-03-26,304.0,670363,13796.0,1869,0.030855,51776,17591473
2022-03-27,303.0,672400,14465.0,2037,0.030855,58000,17649473
2022-03-28,319.0,674680,15170.0,2280,0.030855,78909,17728382
2022-03-29,325.0,676899,15411.0,2219,0.030855,67441,17795823
2022-03-30,318.0,679254,15632.0,2355,0.030855,62750,17858573
2022-03-31,311.0,681378,15648.0,2124,0.030855,45879,17904452
2022-04-01,311.0,683224,15966.0,1846,0.009487499999999899,40342,17944794
2022-04-02,308.0,685050,15739.0,1826,0.009487499999999899,31609,17976403
2022-04-03,306.0,687153,15989.0,2103,0.009487499999999899,35606,18012009
2022-04-04,306.0,689317,16466.0,2164,0.009487499999999899,45140,18057149
2022-04-05,319.0,691625,16552.0,2308,0.009487499999999899,40393,18097542
2022-04-06,317.0,693801,16587.0,2176,0.009487499999999899,36891,18134433
2022-04-07,312.0,695800,16600.0,1999,0.009487499999999899,31745,18166178
2022-04-08,315.0,697551,16366.0,1751,0.009487499999999899,27391,18193569
2022-04-09,323.0,699253,15876.0,1702,0.009487499999999899,23013,18216582
2022-04-10,329.0,701045,16039.0,1792,0.009487499999999899,25641,18242223
2022-04-11,337.0,702954,16442.0,1909,0.009487499999999899,30597,18272820
2022-04-12,339.0,704957,16131.0,2003,0.009487499999999899,27382,18300202
2022-04-13,306.0,706855,15399.0,1898,0.009487499999999899,25507,18325709
2022-04-14,299.0,708517,14955.0,1662,0.009487499999999899,21433,18347142
2022-04-15,271.0,709933,14394.0,1416,0.009487499999999899,17306,18364448
2022-04-16,285.0,711221,14335.0,1288,0.009487499999999899,16091,18380539
2022-04-17,280.0,712568,14254.0,1347,0.009487499999999899,16262,18396801
2022-04-18,274.0,714074,14183.0,1506,0.009487499999999899,20566,18417367
2022-04-19,296.0,715509,14607.0,1435,0.009487499999999899,20595,18437962
2022-04-20,309.0,716831,14164.0,1322,0.009487499999999899,16973,18454935
2022-04-21,294.0,718095,13392.0,1264,0.009487499999999899,14520,18469455
2022-04-22,283.0,719279,12883.0,1184,0.009487499999999899,12526,18481981
2022-04-23,286.0,720366,12156.0,1087,0.009487499999999899,10573,18492554
2022-04-24,287.0,721443,12083.0,1077,0.009487499999999899,11867,18504421
2022-04-25,276.0,722581,11992.0,1138,0.009487499999999899,13403,18517824
2022-04-26,276.0,723681,11320.0,1100,0.009487499999999899,11293,18529117
2022-04-27,260.0,724763,10965.0,1082,0.009487499999999899,10120,18539237
2022-04-28,252.0,725699,10432.0,936,0.009487499999999899,9056,18548293
2022-04-29,259.0,726571,9938.0,872,0.009487499999999899,7992,18556285
2022-04-30,265.0,727289,9499.0,718,0.009487499999999899,6863,18563148
2022-05-01,256.0,728096,9355.0,807,-0.011880000000000102,7718,18570866
2022-05-02,248.0,728924,9326.0,828,-0.011880000000000102,10343,18581209
2022-05-03,237.0,729817,9243.0,893,-0.011880000000000102,11155,18592364
2022-05-04,241.0,730690,8950.0,873,-0.011880000000000102,9783,18602147
2022-05-05,224.0,731467,8596.0,777,-0.011880000000000102,8592,18610739
2022-05-06,211.0,732188,8170.0,721,-0.011880000000000102,7518,18618257
2022-05-07,199.0,732795,7768.0,607,-0.011880000000000102,6354,18624611
2022-05-08,199.0,733464,7715.0,669,-0.011880000000000102,7664,18632275
2022-05-09,187.0,734195,7647.0,731,-0.011880000000000102,8876,18641151
2022-05-10,175.0,734921,7363.0,726,-0.011880000000000102,8154,18649305
2022-05-11,170.0,735592,7034.0,671,-0.011880000000000102,7265,18656570
2022-05-12,162.0,736272,6602.0,680,-0.011880000000000102,6376,18662946
2022-05-13,162.0,736814,6366.0,542,-0.011880000000000102,5794,18668740
2022-05-14,168.0,737367,6147.0,553,-0.011880000000000102,5139,18673879
2022-05-15,170.0,737933,6158.0,566,-0.011880000000000102,6730,18680609
2022-05-16,159.0,738522,6024.0,589,-0.011880000000000102,7883,18688492
2022-05-17,173.0,739098,5733.0,576,-0.011880000000000102,6833,18695325
2022-05-18,161.0,739724,5425.0,626,-0.011880000000000102,6392,18701717
2022-05-19,165.0,740297,5356.0,573,-0.011880000000000102,5785,18707502
2022-05-20,171.0,740747,5187.0,450,-0.011880000000000102,5049,18712551
2022-05-21,164.0,741134,5065.0,387,-0.011880000000000102,4243,18716794
2022-05-22,156.0,741597,5047.0,463,-0.011880000000000102,5151,18721945
2022-05-23,150.0,742102,5010.0,505,-0.011880000000000102,6248,18728193
2022-05-24,142.0,742563,4639.0,461,-0.011880000000000102,5593,18733786
2022-05-25,137.0,743038,4489.0,475,-0.011880000000000102,5189,18738975
2022-05-26,134.0,743459,4365.0,421,-0.011880000000000102,4819,18743794
2022-05-27,134.0,743901,4197.0,442,-0.011880000000000102,4494,18748288
2022-05-28,127.0,744283,4013.0,382,-0.011880000000000102,4153,18752441
2022-05-29,124.0,744711,4018.0,428,-0.011880000000000102,4687,18757128
2022-05-30,121.0,745176,4091.0,465,-0.011880000000000102,5928,18763056
2022-05-31,119.0,745678,4036.0,502,-0.011880000000000102,5734,18768790
2022-06-01,123.0,746158,3800.0,480,-0.0332475000000001,5711,18774501
2022-06-02,126.0,746570,3841.0,412,-0.0332475000000001,5081,18779582
2022-06-03,125.0,746974,3849.0,404,-0.0332475000000001,5581,18785163
2022-06-04,111.0,747417,3835.0,443,-0.0332475000000001,6278,18791441
2022-06-05,113.0,747948,3965.0,531,-0.0332475000000001,8350,18799791
2022-06-06,120.0,748554,4126.0,606,-0.0332475000000001,9798,18809589
2022-06-07,116.0,749131,4108.0,577,-0.0332475000000001,9484,18819073
2022-06-08,124.0,749795,4096.0,664,-0.0332475000000001,9952,18829025
2022-06-09,127.0,750422,4082.0,627,-0.0332475000000001,9589,18838614
2022-06-10,117.0,751011,4262.0,589,-0.0332475000000001,9153,18847767
2022-06-11,125.0,751594,4257.0,583,-0.0332475000000001,8468,18856235
2022-06-12,126.0,752253,4408.0,659,-0.0332475000000001,10718,18866953
2022-06-13,128.0,752975,4602.0,722,-0.0332475000000001,12954,18879907
2022-06-14,130.0,753738,4722.0,763,-0.0332475000000001,12660,18892567
2022-06-15,132.0,754580,4843.0,842,-0.0332475000000001,12387,18904954
2022-06-16,130.0,755402,5008.0,822,-0.0332475000000001,11915,18916869
2022-06-17,120.0,756231,5037.0,829,-0.0332475000000001,11640,18928509
2022-06-18,138.0,757028,5183.0,797,-0.0332475000000001,11634,18940143
2022-06-19,139.0,757970,5436.0,942,-0.0332475000000001,14524,18954667
2022-06-20,150.0,759025,5726.0,1055,-0.0332475000000001,16918,18971585
2022-06-21,149.0,760180,6002.0,1155,-0.0332475000000001,17531,18989116
2022-06-22,149.0,761313,6177.0,1133,-0.0332475000000001,17764,19006880
2022-06-23,154.0,762523,6401.0,1210,-0.0332475000000001,16698,19023578
2022-06-24,168.0,763595,6752.0,1072,-0.0332475000000001,15626,19039204
2022-06-25,177.0,764606,6973.0,1011,-0.0332475000000001,14478,19053682
2022-06-26,188.0,765882,7455.0,1276,-0.0332475000000001,18039,19071721
2022-06-27,192.0,767320,7822.0,1438,-0.0332475000000001,21896,19093617
2022-06-28,205.0,768774,8120.0,1454,-0.0332475000000001,21869,19115486
2022-06-29,200.0,770346,8587.0,1572,-0.0332475000000001,21720,19137206
2022-06-30,211.0,771942,8928.0,1596,-0.0332475000000001,21513,19158719
2022-07-01,219.0,773268,9389.0,1326,-0.05461500000000015,21067,19179786
2022-07-02,213.0,774642,9632.0,1374,-0.05461500000000015,19586,19199372
2022-07-03,218.0,776437,9956.0,1795,-0.05461500000000015,25172,19224544
2022-07-04,223.0,778348,10658.0,1911,-0.05461500000000015,30388,19254932
2022-07-05,229.0,780274,11049.0,1926,-0.05461500000000015,28118,19283050
2022-07-06,217.0,782219,11465.0,1945,-0.05461500000000015,26741,19309791
2022-07-07,232.0,784186,11878.0,1967,-0.05461500000000015,24049,19333840
2022-07-08,228.0,785882,12283.0,1696,-0.05461500000000015,22173,19356013
2022-07-09,229.0,787483,12440.0,1601,-0.05461500000000015,19354,19375367
2022-07-10,250.0,789372,12879.0,1889,-0.05461500000000015,23046,19398413
2022-07-11,264.0,791377,13336.0,2005,-0.05461500000000015,27198,19425611
2022-07-12,264.0,793322,13621.0,1945,-0.05461500000000015,24377,19449988
2022-07-13,274.0,795268,13741.0,1946,-0.05461500000000015,21639,19471627
2022-07-14,282.0,797107,13807.0,1839,-0.05461500000000015,19340,19490967
2022-07-15,287.0,798594,13975.0,1487,-0.05461500000000015,16626,19507593
2022-07-16,305.0,799967,13701.0,1373,-0.05461500000000015,13677,19521270
2022-07-17,292.0,801661,13840.0,1694,-0.05461500000000015,15702,19536972
2022-07-18,307.0,803415,14044.0,1754,-0.05461500000000015,16919,19553891
2022-07-19,318.0,805249,13837.0,1834,-0.05461500000000015,14866,19568757
2022-07-20,287.0,806964,13545.0,1715,-0.05461500000000015,14533,19583290
2022-07-21,283.0,808514,13375.0,1550,-0.05461500000000015,12791,19596081
2022-07-22,292.0,809745,13182.0,1231,-0.05461500000000015,11177,19607258
2022-07-23,279.0,810884,12475.0,1139,-0.05461500000000015,8909,19616167
2022-07-24,300.0,812191,12591.0,1307,-0.05461500000000015,10216,19626383
2022-07-25,303.0,813536,12529.0,1345,-0.05461500000000015,11929,19638312
2022-07-26,290.0,814854,12113.0,1318,-0.05461500000000015,10482,19648794
2022-07-27,273.0,816051,11914.0,1197,-0.05461500000000015,9435,19658229
2022-07-28,268.0,817216,11437.0,1165,-0.05461500000000015,8339,19666568
2022-07-29,253.0,818212,11149.0,996,-0.05461500000000015,7585,19674153
2022-07-30,241.0,819148,10529.0,936,-0.05461500000000015,6612,19680765
2022-07-31,232.0,820286,10431.0,1138,-0.05461500000000015,7672,19688437
2022-08-01,245.0,821406,10417.0,1120,-0.07598250000000016,8814,19697251
2022-08-02,240.0,822468,10177.0,1062,-0.07598250000000016,8165,19705416
2022-08-03,232.0,823527,9817.0,1059,-0.07598250000000016,7419,19712835
2022-08-04,231.0,824544,9498.0,1017,-0.07598250000000016,6524,19719359
2022-08-05,229.0,825454,9152.0,910,-0.07598250000000016,5859,19725218
2022-08-06,221.0,826229,8806.0,775,-0.07598250000000016,4852,19730070
2022-08-07,217.0,827128,8805.0,899,-0.07598250000000016,5897,19735967
2022-08-08,222.0,828103,8888.0,975,-0.07598250000000016,7226,19743193
2022-08-09,233.0,829076,8624.0,973,-0.07598250000000016,6462,19749655
2022-08-10,216.0,830085,8487.0,1009,-0.07598250000000016,6003,19755658
2022-08-11,206.0,830986,8327.0,901,-0.07598250000000016,5446,19761104
2022-08-12,196.0,831726,8072.0,740,-0.07598250000000016,4781,19765885
2022-08-13,192.0,832488,7993.0,762,-0.07598250000000016,3978,19769863
2022-08-14,191.0,833247,8158.0,759,-0.07598250000000016,4781,19774644
2022-08-15,198.0,834108,8088.0,861,-0.07598250000000016,5606,19780250
2022-08-16,195.0,834926,7832.0,818,-0.07598250000000016,4845,19785095
2022-08-17,207.0,835714,7486.0,788,-0.07598250000000016,4421,19789516
2022-08-18,184.0,836406,7421.0,692,-0.07598250000000016,3989,19793505
2022-08-19,182.0,837054,7045.0,648,-0.07598250000000016,3492,19796997
2022-08-20,166.0,837639,6760.0,585,-0.07598250000000016,3059,19800056
2022-08-21,164.0,838244,6687.0,605,-0.07598250000000016,3547,19803603
2022-08-22,162.0,838914,6803.0,670,-0.07598250000000016,4575,19808178
2022-08-23,135.0,839621,6436.0,707,-0.07598250000000016,4076,19812254
2022-08-24,150.0,840264,6302.0,643,-0.07598250000000016,3913,19816167
2022-08-25,141.0,840910,6249.0,646,-0.07598250000000016,3266,19819433
2022-08-26,135.0,841422,5845.0,512,-0.07598250000000016,2997,19822430
2022-08-27,135.0,841897,5765.0,475,-0.07598250000000016,2606,19825036
2022-08-28,138.0,842436,5717.0,539,-0.07598250000000016,2882,19827918
2022-08-29,144.0,843038,5768.0,602,-0.07598250000000016,3936,19831854
2022-08-30,141.0,843650,5743.0,612,-0.07598250000000016,4473,19836327
2022-08-31,144.0,844230,5658.0,580,-0.07598250000000016,3975,19840302
2022-09-01,152.0,844764,5554.0,534,-0.0973500000000001,3760,19844062
2022-09-02,143.0,845230,5334.0,466,-0.0973500000000001,3239,19847301
2022-09-03,135.0,845669,5183.0,439,-0.0973500000000001,2971,19850272
2022-09-04,120.0,846140,5209.0,471,-0.0973500000000001,3759,19854031
2022-09-05,127.0,846666,5221.0,526,-0.0973500000000001,4385,19858416
2022-09-06,135.0,847203,5060.0,537,-0.0973500000000001,3940,19862356
2022-09-07,117.0,847744,4864.0,541,-0.0973500000000001,3749,19866105
2022-09-08,127.0,848252,4881.0,508,-0.0973500000000001,3250,19869355
2022-09-09,122.0,848674,4797.0,422,-0.0973500000000001,3103,19872458
2022-09-10,129.0,849082,4650.0,408,-0.0973500000000001,2861,19875319
2022-09-11,132.0,849581,4692.0,499,-0.0973500000000001,3890,19879209
2022-09-12,124.0,850100,4666.0,519,-0.0973500000000001,4758,19883967
2022-09-13,148.0,850680,4630.0,580,-0.0973500000000001,4601,19888568
2022-09-14,140.0,851266,4540.0,586,-0.0973500000000001,4453,19893021
2022-09-15,132.0,851819,4571.0,553,-0.0973500000000001,4200,19897221
2022-09-16,122.0,852295,4543.0,476,-0.0973500000000001,3729,19900950
2022-09-17,117.0,852779,4467.0,484,-0.0973500000000001,3188,19904138
2022-09-18,127.0,853334,4556.0,555,-0.0973500000000001,3943,19908081
2022-09-19,123.0,854115,4696.0,781,-0.0973500000000001,5702,19913783
2022-09-20,136.0,854941,4886.0,826,-0.0973500000000001,7200,19920983
2022-09-21,145.0,855799,5142.0,858,-0.0973500000000001,6940,19927923
2022-09-22,152.0,856645,5366.0,846,-0.0973500000000001,6294,19934217
2022-09-23,153.0,857349,5604.0,704,-0.0973500000000001,6006,19940223
2022-09-24,150.0,858076,5773.0,727,-0.0973500000000001,5309,19945532
2022-09-25,160.0,859047,6045.0,971,-0.0973500000000001,6737,19952269
2022-09-26,157.0,860045,6439.0,998,-0.0973500000000001,8042,19960311
2022-09-27,161.0,861090,6758.0,1045,-0.0973500000000001,7644,19967955
2022-09-28,160.0,862224,7024.0,1134,-0.0973500000000001,7806,19975761
2022-09-29,160.0,863382,7281.0,1158,-0.0973500000000001,7352,19983113
2022-09-30,155.0,864252,7672.0,870,-0.0973500000000001,7099,19990212
2022-10-01,161.0,865343,8069.0,1091,-0.11871750000000016,6564,19996776
2022-10-02,172.0,866605,8374.0,1262,-0.11871750000000016,8623,20005399
2022-10-03,189.0,867949,8854.0,1344,-0.11871750000000016,10881,20016280
2022-10-04,192.0,869367,9287.0,1418,-0.11871750000000016,10246,20026526
2022-10-05,195.0,870626,9631.0,1259,-0.11871750000000016,9544,20036070
2022-10-06,192.0,871789,9922.0,1163,-0.11871750000000016,8819,20044889
2022-10-07,199.0,872735,10070.0,946,-0.11871750000000016,8333,20053222
2022-10-08,207.0,873620,10049.0,885,-0.11871750000000016,6581,20059803
2022-10-09,201.0,874872,10181.0,1252,-0.11871750000000016,8014,20067817
2022-10-10,209.0,876147,10397.0,1275,-0.11871750000000016,9835,20077652
2022-10-11,224.0,877354,10522.0,1207,-0.11871750000000016,8781,20086433
2022-10-12,221.0,878504,10608.0,1150,-0.11871750000000016,8123,20094556
2022-10-13,232.0,879751,10524.0,1247,-0.11871750000000016,7563,20102119
2022-10-14,224.0,880729,10420.0,978,-0.11871750000000016,7343,20109462
2022-10-15,221.0,881629,10502.0,900,-0.11871750000000016,6005,20115467
2022-10-16,217.0,882835,10584.0,1206,-0.11871750000000016,7257,20122724
2022-10-17,207.0,883956,10688.0,1121,-0.11871750000000016,9301,20132025
2022-10-18,200.0,885057,10594.0,1101,-0.11871750000000016,7666,20139691
2022-10-19,206.0,886121,10387.0,1064,-0.11871750000000016,7042,20146733
2022-10-20,193.0,887174,10129.0,1053,-0.11871750000000016,6075,20152808
2022-10-21,194.0,888005,9935.0,831,-0.11871750000000016,5759,20158567
2022-10-22,197.0,888790,9777.0,785,-0.11871750000000016,4527,20163094
2022-10-23,195.0,889674,9755.0,884,-0.11871750000000016,5011,20168105
2022-10-24,203.0,890544,9692.0,870,-0.11871750000000016,6147,20174252
2022-10-25,229.0,891407,9373.0,863,-0.11871750000000016,5181,20179433
2022-10-26,222.0,892264,9131.0,857,-0.11871750000000016,4924,20184357
2022-10-27,220.0,893037,8860.0,773,-0.11871750000000016,4372,20188729
2022-10-28,217.0,893595,8663.0,558,-0.11871750000000016,3916,20192645
2022-10-29,214.0,894113,8324.0,518,-0.11871750000000016,3227,20195872
2022-10-30,205.0,894753,8235.0,640,-0.11871750000000016,3827,20199699
2022-10-31,181.0,895383,8019.0,630,-0.11871750000000016,4633,20204332
2022-11-01,182.0,896072,7591.0,689,-0.1400850000000002,4091,20208423
2022-11-02,175.0,896643,7296.0,571,-0.1400850000000002,3599,20212022
2022-11-03,166.0,897211,6969.0,568,-0.1400850000000002,3261,20215283
2022-11-04,161.0,897621,6641.0,410,-0.1400850000000002,2760,20218043
2022-11-05,151.0,898017,6358.0,396,-0.1400850000000002,2374,20220417
2022-11-06,152.0,898517,6234.0,500,-0.1400850000000002,2917,20223334
2022-11-07,154.0,899115,6075.0,598,-0.1400850000000002,3879,20227213
2022-11-08,150.0,899665,5905.0,550,-0.1400850000000002,3380,20230593
2022-11-09,150.0,900200,5647.0,535,-0.1400850000000002,3185,20233778
2022-11-10,149.0,900750,5547.0,550,-0.1400850000000002,2806,20236584
2022-11-11,137.0,901185,5372.0,435,-0.1400850000000002,2562,20239146
2022-11-12,139.0,901555,5258.0,370,-0.1400850000000002,2172,20241318
2022-11-13,139.0,902000,5269.0,445,-0.1400850000000002,2647,20243965
2022-11-14,130.0,902522,5284.0,522,-0.1400850000000002,3494,20247459
2022-11-15,132.0,903016,5165.0,494,-0.1400850000000002,3160,20250619
2022-11-16,122.0,903558,5010.0,542,-0.1400850000000002,2933,20253552
2022-11-17,124.0,904074,4842.0,516,-0.1400850000000002,2703,20256255
2022-11-18,129.0,904511,4771.0,437,-0.1400850000000002,2501,20258756
2022-11-19,123.0,904906,4696.0,395,-0.1400850000000002,2207,20260963
2022-11-20,120.0,905340,4706.0,434,-0.1400850000000002,2613,20263576
2022-11-21,103.0,905843,4709.0,503,-0.1400850000000002,3549,20267125
2022-11-22,134.0,906390,4678.0,547,-0.1400850000000002,3451,20270576
2022-11-23,117.0,906926,4600.0,536,-0.1400850000000002,3240,20273816
2022-11-24,122.0,907448,4701.0,522,-0.1400850000000002,3007,20276823
2022-11-25,129.0,907891,4638.0,443,-0.1400850000000002,2638,20279461
2022-11-26,125.0,908329,4568.0,438,-0.1400850000000002,2304,20281765
2022-11-27,128.0,908886,4639.0,557,-0.1400850000000002,3152,20284917
2022-11-28,111.0,909525,4775.0,639,-0.1400850000000002,4237,20289154
2022-11-29,117.0,910186,4847.0,661,-0.1400850000000002,3972,20293126
2022-11-30,128.0,910776,4964.0,590,-0.1400850000000002,3608,20296734
2022-12-01,134.0,911359,4990.0,583,-0.16145250000000022,3214,20299948
2022-12-02,135.0,911827,5027.0,468,-0.16145250000000022,3275,20303223
2022-12-03,124.0,912325,5022.0,498,-0.16145250000000022,2481,20305704
2022-12-04,127.0,912914,5155.0,589,-0.16145250000000022,3409,20309113
2022-12-05,129.0,913638,5285.0,724,-0.16145250000000022,4850,20313963
2022-12-06,127.0,914417,5382.0,779,-0.16145250000000022,4761,20318724
2022-12-07,119.0,915165,5501.0,748,-0.16145250000000022,4640,20323364
2022-12-08,118.0,915862,5632.0,697,-0.16145250000000022,4092,20327456
2022-12-09,113.0,916469,5771.0,607,-0.16145250000000022,3824,20331280
2022-12-10,112.0,917051,5920.0,582,-0.16145250000000022,3286,20334566
2022-12-11,118.0,917923,6057.0,872,-0.16145250000000022,4223,20338789
2022-12-12,129.0,918888,6171.0,965,-0.16145250000000022,6356,20345145
2022-12-13,142.0,919914,6369.0,1026,-0.16145250000000022,6483,20351628
2022-12-14,150.0,920877,6720.0,963,-0.16145250000000022,5962,20357590
2022-12-15,155.0,921941,6924.0,1064,-0.16145250000000022,5549,20363139
2022-12-16,156.0,922775,7157.0,834,-0.16145250000000022,5525,20368664
2022-12-17,163.0,923574,7396.0,799,-0.16145250000000022,4273,20372937
2022-12-18,166.0,924750,7688.0,1176,-0.16145250000000022,5212,20378149
2022-12-19,175.0,926046,8006.0,1296,-0.16145250000000022,8240,20386389
2022-12-20,171.0,927422,8340.0,1376,-0.16145250000000022,7836,20394225
2022-12-21,174.0,928715,8643.0,1293,-0.16145250000000022,7042,20401267
2022-12-22,180.0,929951,8919.0,1236,-0.16145250000000022,6241,20407508
2022-12-23,178.0,930850,9047.0,899,-0.16145250000000022,5225,20412733
2022-12-24,177.0,931630,9044.0,780,-0.16145250000000022,3777,20416510
2022-12-25,162.0,932474,8979.0,844,-0.16145250000000022,3382,20419892
2022-12-26,178.0,933462,9178.0,988,-0.16145250000000022,4499,20424391
2022-12-27,187.0,934596,9250.0,1134,-0.16145250000000022,5977,20430368
2022-12-28,209.0,935841,9459.0,1245,-0.16145250000000022,7609,20437977
2022-12-29,213.0,937066,9535.0,1225,-0.16145250000000022,6953,20444930
2022-12-30,223.0,938006,9530.0,940,-0.16145250000000022,5524,20450454
2022-12-31,208.0,938729,9360.0,723,-0.16145250000000022,3891,20454345
2023-01-01,220.0,939513,9417.0,784,-0.1828200000000002,3337,20457682
2023-01-02,227.0,940429,9431.0,916,-0.1828200000000002,4636,20462318
2023-01-03,218.0,941421,9291.0,992,-0.1828200000000002,5739,20468057
2023-01-04,212.0,942343,9332.0,922,-0.1828200000000002,5009,20473066
2023-01-05,202.0,943242,9072.0,899,-0.1828200000000002,4168,20477234
2023-01-06,209.0,943947,8671.0,705,-0.1828200000000002,3412,20480646
2023-01-07,202.0,944575,8547.0,628,-0.1828200000000002,2417,20483063
2023-01-08,189.0,945351,8396.0,776,-0.1828200000000002,2501,20485564
2023-01-09,195.0,946088,8368.0,737,-0.1828200000000002,3212,20488776
2023-01-10,191.0,946749,8034.0,661,-0.1828200000000002,2802,20491578
2023-01-11,182.0,947441,7743.0,692,-0.1828200000000002,2372,20493950
2023-01-12,169.0,948105,7421.0,664,-0.1828200000000002,2204,20496154
2023-01-13,166.0,948615,7164.0,510,-0.1828200000000002,1904,20498058
2023-01-14,147.0,949032,6863.0,417,-0.1828200000000002,1327,20499385
2023-01-15,137.0,949599,6780.0,567,-0.1828200000000002,1673,20501058
2023-01-16,153.0,950198,6721.0,599,-0.1828200000000002,2307,20503365
2023-01-17,148.0,950763,6593.0,565,-0.1828200000000002,1987,20505352
2023-01-18,146.0,951358,6299.0,595,-0.1828200000000002,1901,20507253
2023-01-19,142.0,951976,5996.0,618,-0.1828200000000002,1808,20509061
2023-01-20,133.0,952423,5888.0,447,-0.1828200000000002,1699,20510760
2023-01-21,138.0,952916,5706.0,493,-0.1828200000000002,1400,20512160
2023-01-22,146.0,953506,5697.0,590,-0.1828200000000002,1747,20513907
2023-01-23,142.0,954123,5817.0,617,-0.1828200000000002,2382,20516289
2023-01-24,136.0,954818,5639.0,695,-0.1828200000000002,2550,20518839
2023-01-25,126.0,955524,5632.0,706,-0.1828200000000002,2422,20521261
2023-01-26,133.0,956178,5683.0,654,-0.1828200000000002,2338,20523599
2023-01-27,131.0,956736,5708.0,558,-0.1828200000000002,2270,20525869
2023-01-28,140.0,957298,5750.0,562,-0.1828200000000002,1802,20527671
2023-01-29,145.0,958003,5834.0,705,-0.1828200000000002,2249,20529920
2023-01-30,142.0,958744,5959.0,741,-0.1828200000000002,3270,20533190
2023-01-31,136.0,959496,6015.0,752,-0.1828200000000002,3280,20536470
2023-02-01,136.0,960276,6055.0,780,-0.20418750000000024,3214,20539684
2023-02-02,142.0,960989,6197.0,713,-0.20418750000000024,2956,20542640
2023-02-03,139.0,961562,6288.0,573,-0.20418750000000024,2751,20545391
2023-02-04,137.0,962230,6203.0,668,-0.20418750000000024,2223,20547614
2023-02-05,134.0,962977,6332.0,747,-0.20418750000000024,2616,20550230
2023-02-06,128.0,963802,6484.0,825,-0.20418750000000024,3621,20553851
2023-02-07,132.0,964619,6405.0,817,-0.20418750000000024,3395,20557246
2023-02-08,117.0,965387,6382.0,768,-0.20418750000000024,3335,20560581
2023-02-09,118.0,966205,6403.0,818,-0.20418750000000024,3043,20563624
2023-02-10,133.0,966848,6455.0,643,-0.20418750000000024,3051,20566675
2023-02-11,128.0,967591,6473.0,743,-0.20418750000000024,2396,20569071
2023-02-12,123.0,968457,6725.0,866,-0.20418750000000024,2920,20571991
2023-02-13,129.0,969406,6953.0,949,-0.20418750000000024,4548,20576539
2023-02-14,140.0,970318,7031.0,912,-0.20418750000000024,4356,20580895
2023-02-15,137.0,971296,7209.0,978,-0.20418750000000024,3894,20584789
2023-02-16,139.0,972255,7277.0,959,-0.20418750000000024,4005,20588794
2023-02-17,134.0,973040,7371.0,785,-0.20418750000000024,3780,20592574
2023-02-18,137.0,973789,7484.0,749,-0.20418750000000024,2907,20595481
2023-02-19,146.0,974701,7665.0,912,-0.20418750000000024,3435,20598916
2023-02-20,149.0,975684,7919.0,983,-0.20418750000000024,4552,20603468
2023-02-21,154.0,976651,7906.0,967,-0.20418750000000024,4326,20607794
2023-02-22,164.0,977530,8015.0,879,-0.20418750000000024,3855,20611649
2023-02-23,155.0,978375,8107.0,845,-0.20418750000000024,3475,20615124
2023-02-24,156.0,979040,7598.0,665,-0.20418750000000024,3112,20618236
2023-02-25,156.0,979769,7486.0,729,-0.20418750000000024,2529,20620765
2023-02-26,163.0,980662,7580.0,893,-0.20418750000000024,2901,20623666
2023-02-27,168.0,981595,7622.0,933,-0.20418750000000024,4319,20627985
2023-02-28,169.0,982537,7598.0,942,-0.20418750000000024,4147,20632132
2023-03-01,175.0,983530,7507.0,993,-0.22555500000000023,3973,20636105
2023-03-02,166.0,984477,7522.0,947,-0.22555500000000023,3565,20639670
2023-03-03,158.0,985227,7468.0,750,-0.22555500000000023,3421,20643091
2023-03-04,141.0,985970,7330.0,743,-0.22555500000000023,2572,20645663
2023-03-05,147.0,986844,7470.0,874,-0.22555500000000023,3155,20648818
2023-03-06,152.0,987883,7572.0,1039,-0.22555500000000023,4577,20653395
2023-03-07,158.0,988928,7588.0,1045,-0.22555500000000023,4455,20657850
2023-03-08,166.0,990050,7655.0,1122,-0.22555500000000023,4318,20662168
2023-03-09,167.0,991028,7619.0,978,-0.22555500000000023,3961,20666129
2023-03-10,180.0,991811,7935.0,783,-0.22555500000000023,3592,20669721
2023-03-11,167.0,992681,7866.0,870,-0.22555500000000023,3084,20672805
2023-03-12,188.0,993752,7989.0,1071,-0.22555500000000023,4026,20676831
2023-03-13,174.0,994941,8253.0,1189,-0.22555500000000023,5289,20682120
2023-03-14,183.0,996041,8362.0,1100,-0.22555500000000023,5072,20687192
2023-03-15,184.0,997052,8434.0,1011,-0.22555500000000023,4371,20691563
2023-03-16,179.0,998128,8378.0,1076,-0.22555500000000023,4351,20695914
2023-03-17,172.0,998970,8340.0,842,-0.22555500000000023,3718,20699632
2023-03-18,176.0,999823,8339.0,853,-0.22555500000000023,3105,20702737
2023-03-19,174.0,1000872,8441.0,1049,-0.22555500000000023,3683,20706420
2023-03-20,175.0,1001891,8631.0,1019,-0.22555500000000023,4730,20711150
2023-03-21,173.0,1002956,8576.0,1065,-0.22555500000000023,4747,20715897
2023-03-22,172.0,1003984,8387.0,1028,-0.22555500000000023,4323,20720220
2023-03-23,176.0,1004995,8403.0,1011,-0.22555500000000023,3969,20724189
2023-03-24,170.0,1005757,8304.0,762,-0.22555500000000023,3744,20727933
2023-03-25,178.0,1006487,8234.0,730,-0.22555500000000023,2748,20730681
2023-03-26,179.0,1007312,8265.0,825,-0.22555500000000023,3156,20733837
2023-03-27,179.0,1008198,8316.0,886,-0.22555500000000023,3924,20737761
2023-03-28,185.0,1009132,8080.0,934,-0.22555500000000023,3597,20741358
2023-03-29,192.0,1010153,7963.0,1021,-0.22555500000000023,3438,20744796
2023-03-30,193.0,1011000,7777.0,847,-0.22555500000000023,3050,20747846
2023-03-31,186.0,1011699,7759.0,699,-0.22555500000000023,2509,20750355
2023-04-01,164.0,1012417,7520.0,718,-0.2469225000000002,2083,20752438
2023-04-02,170.0,1013188,7556.0,771,-0.2469225000000002,2249,20754687
2023-04-03,166.0,1013958,7566.0,770,-0.2469225000000002,2457,20757144
2023-04-04,165.0,1014744,7455.0,786,-0.2469225000000002,2185,20759329
2023-04-05,165.0,1015518,7005.0,774,-0.2469225000000002,2237,20761566
2023-04-06,137.0,1016137,6829.0,619,-0.2469225000000002,1966,20763532
2023-04-07,144.0,1016657,6599.0,520,-0.2469225000000002,1599,20765131
2023-04-08,145.0,1017183,6462.0,526,-0.2469225000000002,1531,20766662
2023-04-09,136.0,1017795,6372.0,612,-0.2469225000000002,1643,20768305
2023-04-10,143.0,1018514,7029.0,719,-0.2469225000000002,2133,20770438
2023-04-11,138.0,1019237,6593.0,723,-0.2469225000000002,2281,20772719
2023-04-12,135.0,1019865,6428.0,628,-0.2469225000000002,2054,20774773
2023-04-13,138.0,1020485,6277.0,620,-0.2469225000000002,1880,20776653
2023-04-14,143.0,1020977,6013.0,492,-0.2469225000000002,1553,20778206
2023-04-15,142.0,1021486,5793.0,509,-0.2469225000000002,1271,20779477
2023-04-16,152.0,1022062,5764.0,576,-0.2469225000000002,1788,20781265
2023-04-17,134.0,1022721,5756.0,659,-0.2469225000000002,2060,20783325
2023-04-18,126.0,1023278,5619.0,557,-0.2469225000000002,1803,20785128
2023-04-19,118.0,1023844,5590.0,566,-0.2469225000000002,1703,20786831
2023-04-20,114.0,1024337,5412.0,493,-0.2469225000000002,1488,20788319
2023-04-21,112.0,1024765,5182.0,428,-0.2469225000000002,1343,20789662
2023-04-22,109.0,1025176,4988.0,411,-0.2469225000000002,1191,20790853
2023-04-23,120.0,1025746,4978.0,570,-0.2469225000000002,1432,20792285
2023-04-24,99.0,1026271,5043.0,525,-0.2469225000000002,1706,20793991
2023-04-25,96.0,1026782,4924.0,511,-0.2469225000000002,1604,20795595
2023-04-26,101.0,1027321,4809.0,539,-0.2469225000000002,1569,20797164
2023-04-27,105.0,1027846,4710.0,525,-0.2469225000000002,1514,20798678
2023-04-28,94.0,1028250,4631.0,404,-0.2469225000000002,1369,20800047
2023-04-29,94.0,1028644,4395.0,394,-0.2469225000000002,1211,20801258
2023-04-30,110.0,1029072,4554.0,428,-0.2469225000000002,1240,20802498
2023-05-01,110.0,1029589,4592.0,517,-0.2682900000000003,1651,20804149
2023-05-02,118.0,1030094,4646.0,505,-0.2682900000000003,1776,20805925
2023-05-03,124.0,1030544,4585.0,450,-0.2682900000000003,1525,20807450
2023-05-04,113.0,1030987,4431.0,443,-0.2682900000000003,1478,20808928
2023-05-05,100.0,1031393,4350.0,406,-0.2682900000000003,1198,20810126
2023-05-06,104.0,1031775,4253.0,382,-0.2682900000000003,934,20811060
2023-05-07,107.0,1032135,4224.0,360,-0.2682900000000003,1108,20812168
2023-05-08,102.0,1032591,4292.0,456,-0.2682900000000003,1328,20813496
2023-05-09,97.0,1033048,4223.0,457,-0.2682900000000003,1446,20814942
2023-05-10,100.0,1033507,4207.0,459,-0.2682900000000003,1267,20816209
2023-05-11,88.0,1033913,3980.0,406,-0.2682900000000003,1196,20817405
2023-05-12,102.0,1034222,3928.0,309,-0.2682900000000003,948,20818353
2023-05-13,105.0,1034493,3825.0,271,-0.2682900000000003,782,20819135
2023-05-14,99.0,1034838,3802.0,345,-0.2682900000000003,1030,20820165
2023-05-15,96.0,1035212,3719.0,374,-0.2682900000000003,1137,20821302
2023-05-16,102.0,1035595,3632.0,383,-0.2682900000000003,1069,20822371
2023-05-17,89.0,1035945,3550.0,350,-0.2682900000000003,991,20823362
2023-05-18,90.0,1036288,3471.0,343,-0.2682900000000003,974,20824336
2023-05-19,92.0,1036541,3362.0,253,-0.2682900000000003,882,20825218
2023-05-20,88.0,1036788,3246.0,247,-0.2682900000000003,717,20825935
2023-05-21,84.0,1037116,3207.0,328,-0.2682900000000003,881,20826816
2023-05-22,81.0,1037480,3133.0,364,-0.2682900000000003,1095,20827911
2023-05-23,85.0,1037861,3114.0,381,-0.2682900000000003,1041,20828952
2023-05-24,81.0,1038201,3116.0,340,-0.2682900000000003,921,20829873
2023-05-25,82.0,1038523,3009.0,322,-0.2682900000000003,821,20830694
2023-05-26,79.0,1038769,2983.0,246,-0.2682900000000003,708,20831402
2023-05-27,79.0,1038988,2820.0,219,-0.2682900000000003,567,20831969
2023-05-28,75.0,1039245,2772.0,257,-0.2682900000000003,594,20832563
2023-05-29,67.0,1039544,2831.0,299,-0.2682900000000003,746,20833309
2023-05-30,69.0,1039861,2775.0,317,-0.2682900000000003,780,20834089
2023-05-31,77.0,1040151,2780.0,290,-0.2682900000000003,813,20834902
